TCACAATTACT -> CACAATTACTT
CACAATTACTT -> ACAATTACTTT
ACAATTACTTT -> CAATTACTTTG
CAATTACTTTG -> AATTACTTTGC
AATTACTTTGC -> ATTACTTTGCT
ATTACTTTGCT -> TTACTTTGCTG
TTACTTTGCTG -> TACTTTGCTGT
TACTTTGCTGT -> ACTTTGCTGTG
ACTTTGCTGTG -> CTTTGCTGTGT
CTTTGCTGTGT -> TTTGCTGTGTT
TTTGCTGTGTT -> TTGCTGTGTTC
TTGCTGTGTTC -> TGCTGTGTTCA
TGCTGTGTTCA -> GCTGTGTTCAT
GCTGTGTTCAT -> CTGTGTTCATC
CTGTGTTCATC -> TGTGTTCATCA
TGTGTTCATCA -> GTGTTCATCAC
GTGTTCATCAC -> TGTTCATCACC
TGTTCATCACC -> GTTCATCACCG
GTTCATCACCG -> TTCATCACCGC
TTCATCACCGC -> TCATCACCGCA
TCATCACCGCA -> CATCACCGCAA
CATCACCGCAA -> ATCACCGCAAA
ATCACCGCAAA -> TCACCGCAAAC
TCACCGCAAAC -> CACCGCAAACG
CACCGCAAACG -> ACCGCAAACGA
ACCGCAAACGA -> CCGCAAACGAT
CCGCAAACGAT -> CGCAAACGATG
CGCAAACGATG -> GCAAACGATGA
GCAAACGATGA -> CAAACGATGAC
CAAACGATGAC -> AAACGATGACG
AAACGATGACG -> AACGATGACGC
AACGATGACGC -> ACGATGACGCA
ACGATGACGCA -> CGATGACGCAA
CGATGACGCAA -> GATGACGCAAG
GATGACGCAAG -> ATGACGCAAGC
ATGACGCAAGC -> TGACGCAAGCA
TGACGCAAGCA -> GACGCAAGCAG
GACGCAAGCAG -> ACGCAAGCAGT
ACGCAAGCAGT -> CGCAAGCAGTA
CGCAAGCAGTA -> GCAAGCAGTAG
GCAAGCAGTAG -> CAAGCAGTAGA
CAAGCAGTAGA -> AAGCAGTAGAT
AAGCAGTAGAT -> AGCAGTAGATG
AGCAGTAGATG -> GCAGTAGATGA
GCAGTAGATGA -> CAGTAGATGAC
CAGTAGATGAC -> AGTAGATGACC
AGTAGATGACC -> GTAGATGACCC
GTAGATGACCC -> TAGATGACCCC
TAGATGACCCC -> AGATGACCCCA
AGATGACCCCA -> GATGACCCCAA
GATGACCCCAA -> ATGACCCCAAA
ATGACCCCAAA -> TGACCCCAAAG
TGACCCCAAAG -> GACCCCAAAGG
GACCCCAAAGG -> ACCCCAAAGGG
ACCCCAAAGGG -> CCCCAAAGGGC
CCCCAAAGGGC -> CCCAAAGGGCT
CCCAAAGGGCT -> CCAAAGGGCTG
CCAAAGGGCTG -> CAAAGGGCTGG
CAAAGGGCTGG -> AAAGGGCTGGA
AAAGGGCTGGA -> AAGGGCTGGAC
AAGGGCTGGAC -> AGGGCTGGACC
AGGGCTGGACC -> GGGCTGGACCC
GGGCTGGACCC -> GGCTGGACCCA
GGCTGGACCCA -> GCTGGACCCAC
GCTGGACCCAC -> CTGGACCCACT
CTGGACCCACT -> TGGACCCACTG
TGGACCCACTG -> GGACCCACTGG
GGACCCACTGG -> GACCCACTGGC
GACCCACTGGC -> ACCCACTGGCC
ACCCACTGGCC -> CCCACTGGCCC
CCCACTGGCCC -> CCACTGGCCCG
CCACTGGCCCG -> CACTGGCCCGG
CACTGGCCCGG -> ACTGGCCCGGC
ACTGGCCCGGC -> CTGGCCCGGCT
CTGGCCCGGCT -> TGGCCCGGCTA
TGGCCCGGCTA -> GGCCCGGCTAT
GGCCCGGCTAT -> GCCCGGCTATG
GCCCGGCTATG -> CCCGGCTATGG
CCCGGCTATGG -> CCGGCTATGGT
CCGGCTATGGT -> CGGCTATGGTT
CGGCTATGGTT -> GGCTATGGTTA
GGCTATGGTTA -> GCTATGGTTAG
GCTATGGTTAG -> CTATGGTTAGT
CTATGGTTAGT -> TATGGTTAGTG
TATGGTTAGTG -> ATGGTTAGTGA
ATGGTTAGTGA -> TGGTTAGTGAT
TGGTTAGTGAT -> GGTTAGTGATC
GGTTAGTGATC -> GTTAGTGATCA
GTTAGTGATCA -> TTAGTGATCAT
TTAGTGATCAT -> TAGTGATCATC
TAGTGATCATC -> AGTGATCATCC
AGTGATCATCC -> GTGATCATCCT
GTGATCATCCT -> TGATCATCCTG
TGATCATCCTG -> GATCATCCTGG
GATCATCCTGG -> ATCATCCTGGG
ATCATCCTGGG -> TCATCCTGGGC
TCATCCTGGGC -> CATCCTGGGCA
CATCCTGGGCA -> ATCCTGGGCAT
ATCCTGGGCAT -> TCCTGGGCATG
TCCTGGGCATG -> CCTGGGCATGA
CCTGGGCATGA -> CTGGGCATGAG
CTGGGCATGAG -> TGGGCATGAGC
TGGGCATGAGC -> GGGCATGAGCT
GGGCATGAGCT -> GGCATGAGCTG
GGCATGAGCTG -> GCATGAGCTGC
GCATGAGCTGC -> CATGAGCTGCG
CATGAGCTGCG -> ATGAGCTGCGC
ATGAGCTGCGC -> TGAGCTGCGCT
TGAGCTGCGCT -> GAGCTGCGCTA
GAGCTGCGCTA -> AGCTGCGCTAA
AGCTGCGCTAA -> GCTGCGCTAAA
GCTGCGCTAAA -> CTGCGCTAAAT
CTGCGCTAAAT -> TGCGCTAAATT
TGCGCTAAATT -> GCGCTAAATTT
GCGCTAAATTT -> CGCTAAATTTG
CGCTAAATTTG -> GCTAAATTTGT
GCTAAATTTGT -> CTAAATTTGTA
CTAAATTTGTA -> TAAATTTGTAA
TAAATTTGTAA -> AAATTTGTAAG
AAATTTGTAAG -> AATTTGTAAGT
AATTTGTAAGT -> ATTTGTAAGTG
ATTTGTAAGTG -> TTTGTAAGTGA
TTTGTAAGTGA -> TTGTAAGTGAC
TTGTAAGTGAC -> TGTAAGTGACT
TGTAAGTGACT -> GTAAGTGACTT
GTAAGTGACTT -> TAAGTGACTTC
TAAGTGACTTC -> AAGTGACTTCG
AAGTGACTTCG -> AGTGACTTCGG
AGTGACTTCGG -> GTGACTTCGGT
GTGACTTCGGT -> TGACTTCGGTA
TGACTTCGGTA -> GACTTCGGTAA
GACTTCGGTAA -> ACTTCGGTAAA
ACTTCGGTAAA -> CTTCGGTAAAT
CTTCGGTAAAT -> TTCGGTAAATC
TTCGGTAAATC -> TCGGTAAATCA
TCGGTAAATCA -> CGGTAAATCAA
CGGTAAATCAA -> GGTAAATCAAG
GGTAAATCAAG -> GTAAATCAAGG
GTAAATCAAGG -> TAAATCAAGGC
TAAATCAAGGC -> AAATCAAGGCG
AAATCAAGGCG -> AATCAAGGCGT
AATCAAGGCGT -> ATCAAGGCGTC
ATCAAGGCGTC -> TCAAGGCGTCG
TCAAGGCGTCG -> CAAGGCGTCGT
CAAGGCGTCGT -> AAGGCGTCGTG
AAGGCGTCGTG -> AGGCGTCGTGC
AGGCGTCGTGC -> GGCGTCGTGCT
GGCGTCGTGCT -> GCGTCGTGCTT
GCGTCGTGCTT -> CGTCGTGCTTA
CGTCGTGCTTA -> GTCGTGCTTAA
GTCGTGCTTAA -> TCGTGCTTAAG
TCGTGCTTAAG -> CGTGCTTAAGG
CGTGCTTAAGG -> GTGCTTAAGGG
GTGCTTAAGGG -> TGCTTAAGGGG
TGCTTAAGGGG -> GCTTAAGGGGC
GCTTAAGGGGC -> CTTAAGGGGCA
CTTAAGGGGCA -> TTAAGGGGCAC
TTAAGGGGCAC -> TAAGGGGCACG
TAAGGGGCACG -> AAGGGGCACGA
AAGGGGCACGA -> AGGGGCACGAT
AGGGGCACGAT -> GGGGCACGATG
GGGGCACGATG -> GGGCACGATGG
GGGCACGATGG -> GGCACGATGGT
GGCACGATGGT -> GCACGATGGTT
GCACGATGGTT -> CACGATGGTTG
CACGATGGTTG -> ACGATGGTTGG
ACGATGGTTGG -> CGATGGTTGGA
CGATGGTTGGA -> GATGGTTGGAA
GATGGTTGGAA -> ATGGTTGGAAG
ATGGTTGGAAG -> TGGTTGGAAGG
TGGTTGGAAGG -> GGTTGGAAGGT
GGTTGGAAGGT -> GTTGGAAGGTG
GTTGGAAGGTG -> TTGGAAGGTGG
TTGGAAGGTGG -> TGGAAGGTGGA
TGGAAGGTGGA -> GGAAGGTGGAA
GGAAGGTGGAA -> GAAGGTGGAAT
GAAGGTGGAAT -> AAGGTGGAATC
AAGGTGGAATC -> AGGTGGAATCG
AGGTGGAATCG -> GGTGGAATCGC
GGTGGAATCGC -> GTGGAATCGCG
GTGGAATCGCG -> TGGAATCGCGC
TGGAATCGCGC -> GGAATCGCGCT
GGAATCGCGCT -> GAATCGCGCTC
GAATCGCGCTC -> AATCGCGCTCT
AATCGCGCTCT -> ATCGCGCTCTT
ATCGCGCTCTT -> TCGCGCTCTTT
TCGCGCTCTTT -> CGCGCTCTTTG
CGCGCTCTTTG -> GCGCTCTTTGC
GCGCTCTTTGC -> CGCTCTTTGCG
CGCTCTTTGCG -> GCTCTTTGCGG
GCTCTTTGCGG -> CTCTTTGCGGT
CTCTTTGCGGT -> TCTTTGCGGTC
TCTTTGCGGTC -> CTTTGCGGTCG
CTTTGCGGTCG -> TTTGCGGTCGT
TTTGCGGTCGT -> TTGCGGTCGTC
TTGCGGTCGTC -> TGCGGTCGTCA
TGCGGTCGTCA -> GCGGTCGTCAG
GCGGTCGTCAG -> CGGTCGTCAGC
CGGTCGTCAGC -> GGTCGTCAGCC
GGTCGTCAGCC -> GTCGTCAGCCG
GTCGTCAGCCG -> TCGTCAGCCGG
TCGTCAGCCGG -> CGTCAGCCGGC
CGTCAGCCGGC -> GTCAGCCGGCG
GTCAGCCGGCG -> TCAGCCGGCGT
TCAGCCGGCGT -> CAGCCGGCGTA
CAGCCGGCGTA -> AGCCGGCGTAC
AGCCGGCGTAC -> GCCGGCGTACT
GCCGGCGTACT -> CCGGCGTACTG
CCGGCGTACTG -> CGGCGTACTGT
CGGCGTACTGT -> GGCGTACTGTT
GGCGTACTGTT -> GCGTACTGTTT
GCGTACTGTTT -> CGTACTGTTTC
CGTACTGTTTC -> GTACTGTTTCG
GTACTGTTTCG -> TACTGTTTCGC
TACTGTTTCGC -> ACTGTTTCGCA
ACTGTTTCGCA -> CTGTTTCGCAA
CTGTTTCGCAA -> TGTTTCGCAAG
TGTTTCGCAAG -> GTTTCGCAAGG
GTTTCGCAAGG -> TTTCGCAAGGG
TTTCGCAAGGG -> TTCGCAAGGGG
TTCGCAAGGGG -> TCGCAAGGGGG
TCGCAAGGGGG -> CGCAAGGGGGA
CGCAAGGGGGA -> GCAAGGGGGAA
GCAAGGGGGAA -> CAAGGGGGAAC
CAAGGGGGAAC -> AAGGGGGAACG
AAGGGGGAACG -> AGGGGGAACGC
AGGGGGAACGC -> GGGGGAACGCT
GGGGGAACGCT -> GGGGAACGCTG
GGGGAACGCTG -> GGGAACGCTGA
GGGAACGCTGA -> GGAACGCTGAT
GGAACGCTGAT -> GAACGCTGATC
GAACGCTGATC -> AACGCTGATCT
AACGCTGATCT -> ACGCTGATCTC
ACGCTGATCTC -> CGCTGATCTCG
CGCTGATCTCG -> GCTGATCTCGG
GCTGATCTCGG -> CTGATCTCGGA
CTGATCTCGGA -> TGATCTCGGAA
TGATCTCGGAA -> GATCTCGGAAC
GATCTCGGAAC -> ATCTCGGAACG
ATCTCGGAACG -> TCTCGGAACGT
TCTCGGAACGT -> CTCGGAACGTA
CTCGGAACGTA -> TCGGAACGTAG
TCGGAACGTAG -> CGGAACGTAGG
CGGAACGTAGG -> GGAACGTAGGA
GGAACGTAGGA -> GAACGTAGGAT
GAACGTAGGAT -> AACGTAGGATC
AACGTAGGATC -> ACGTAGGATCA
ACGTAGGATCA -> CGTAGGATCAG
CGTAGGATCAG -> GTAGGATCAGT
GTAGGATCAGT -> TAGGATCAGTG
TAGGATCAGTG -> AGGATCAGTGT
AGGATCAGTGT -> GGATCAGTGTC
GGATCAGTGTC -> GATCAGTGTCC
GATCAGTGTCC -> ATCAGTGTCCA
ATCAGTGTCCA -> TCAGTGTCCAA
TCAGTGTCCAA -> CAGTGTCCAAG
CAGTGTCCAAG -> AGTGTCCAAGT
AGTGTCCAAGT -> GTGTCCAAGTA
GTGTCCAAGTA -> TGTCCAAGTAG
TGTCCAAGTAG -> GTCCAAGTAGG
GTCCAAGTAGG -> TCCAAGTAGGA
TCCAAGTAGGA -> CCAAGTAGGAG
CCAAGTAGGAG -> CAAGTAGGAGA
CAAGTAGGAGA -> AAGTAGGAGAA
AAGTAGGAGAA -> AGTAGGAGAAT
AGTAGGAGAAT -> GTAGGAGAATC
GTAGGAGAATC -> TAGGAGAATCA
TAGGAGAATCA -> AGGAGAATCAT
AGGAGAATCAT -> GGAGAATCATC
GGAGAATCATC -> GAGAATCATCG
GAGAATCATCG -> AGAATCATCGG
AGAATCATCGG -> GAATCATCGGA
GAATCATCGGA -> AATCATCGGAC
AATCATCGGAC -> ATCATCGGACC
ATCATCGGACC -> TCATCGGACCT
TCATCGGACCT -> CATCGGACCTA
CATCGGACCTA -> ATCGGACCTAT
ATCGGACCTAT -> TCGGACCTATC
TCGGACCTATC -> CGGACCTATCT
CGGACCTATCT -> GGACCTATCTT
GGACCTATCTT -> GACCTATCTTG
GACCTATCTTG -> ACCTATCTTGA
ACCTATCTTGA -> CCTATCTTGAC
CCTATCTTGAC -> CTATCTTGACA
CTATCTTGACA -> TATCTTGACAT
TATCTTGACAT -> ATCTTGACATG
ATCTTGACATG -> TCTTGACATGT
TCTTGACATGT -> CTTGACATGTG
CTTGACATGTG -> TTGACATGTGC
TTGACATGTGC -> TGACATGTGCT
TGACATGTGCT -> GACATGTGCTA
GACATGTGCTA -> ACATGTGCTAT
ACATGTGCTAT -> CATGTGCTATA
CATGTGCTATA -> ATGTGCTATAG
ATGTGCTATAG -> TGTGCTATAGG
TGTGCTATAGG -> GTGCTATAGGT
GTGCTATAGGT -> TGCTATAGGTG
TGCTATAGGTG -> GCTATAGGTGG
GCTATAGGTGG -> CTATAGGTGGA
CTATAGGTGGA -> TATAGGTGGAC
TATAGGTGGAC -> ATAGGTGGACG
ATAGGTGGACG -> TAGGTGGACGA
TAGGTGGACGA -> AGGTGGACGAC
AGGTGGACGAC -> GGTGGACGACT
GGTGGACGACT -> GTGGACGACTC
GTGGACGACTC -> TGGACGACTCA
TGGACGACTCA -> GGACGACTCAG
GGACGACTCAG -> GACGACTCAGG
GACGACTCAGG -> ACGACTCAGGG
ACGACTCAGGG -> CGACTCAGGGG
CGACTCAGGGG -> GACTCAGGGGT
GACTCAGGGGT -> ACTCAGGGGTC
ACTCAGGGGTC -> CTCAGGGGTCA
CTCAGGGGTCA -> TCAGGGGTCAA
TCAGGGGTCAA -> CAGGGGTCAAT
CAGGGGTCAAT -> AGGGGTCAATT
AGGGGTCAATT -> GGGGTCAATTC
GGGGTCAATTC -> GGGTCAATTCA
GGGTCAATTCA -> GGTCAATTCAG
GGTCAATTCAG -> GTCAATTCAGT
GTCAATTCAGT -> TCAATTCAGTC
TCAATTCAGTC -> CAATTCAGTCT
CAATTCAGTCT -> AATTCAGTCTA
AATTCAGTCTA -> ATTCAGTCTAA
ATTCAGTCTAA -> TTCAGTCTAAA
TTCAGTCTAAA -> TCAGTCTAAAC
TCAGTCTAAAC -> CAGTCTAAACA
CAGTCTAAACA -> AGTCTAAACAT
AGTCTAAACAT -> GTCTAAACATT
GTCTAAACATT -> TCTAAACATTA
TCTAAACATTA -> CTAAACATTAT
CTAAACATTAT -> TAAACATTATC
TAAACATTATC -> AAACATTATCA
AAACATTATCA -> AACATTATCAG
AACATTATCAG -> ACATTATCAGC
ACATTATCAGC -> CATTATCAGCT
CATTATCAGCT -> ATTATCAGCTT
ATTATCAGCTT -> TTATCAGCTTG
TTATCAGCTTG -> TATCAGCTTGG
TATCAGCTTGG -> ATCAGCTTGGC
ATCAGCTTGGC -> TCAGCTTGGCT
TCAGCTTGGCT -> CAGCTTGGCTA
CAGCTTGGCTA -> AGCTTGGCTAG
AGCTTGGCTAG -> GCTTGGCTAGG
GCTTGGCTAGG -> CTTGGCTAGGA
CTTGGCTAGGA -> TTGGCTAGGAC
TTGGCTAGGAC -> TGGCTAGGACT
TGGCTAGGACT -> GGCTAGGACTA
GGCTAGGACTA -> GCTAGGACTAG
GCTAGGACTAG -> CTAGGACTAGT
CTAGGACTAGT -> TAGGACTAGTA
TAGGACTAGTA -> AGGACTAGTAG
AGGACTAGTAG -> GGACTAGTAGT
GGACTAGTAGT -> GACTAGTAGTG
GACTAGTAGTG -> ACTAGTAGTGT
ACTAGTAGTGT -> CTAGTAGTGTT
CTAGTAGTGTT -> TAGTAGTGTTC
TAGTAGTGTTC -> AGTAGTGTTCT
AGTAGTGTTCT -> GTAGTGTTCTT
GTAGTGTTCTT -> TAGTGTTCTTG
TAGTGTTCTTG -> AGTGTTCTTGT
AGTGTTCTTGT -> GTGTTCTTGTG
GTGTTCTTGTG -> TGTTCTTGTGC
TGTTCTTGTGC -> GTTCTTGTGCC
GTTCTTGTGCC -> TTCTTGTGCCG
TTCTTGTGCCG -> TCTTGTGCCGG
TCTTGTGCCGG -> CTTGTGCCGGG
CTTGTGCCGGG -> TTGTGCCGGGA
TTGTGCCGGGA -> TGTGCCGGGAT
TGTGCCGGGAT -> GTGCCGGGATT
GTGCCGGGATT -> TGCCGGGATTT
TGCCGGGATTT -> GCCGGGATTTC
GCCGGGATTTC -> CCGGGATTTCC
CCGGGATTTCC -> CGGGATTTCCA
CGGGATTTCCA -> GGGATTTCCAG
GGGATTTCCAG -> GGATTTCCAGG
GGATTTCCAGG -> GATTTCCAGGC
GATTTCCAGGC -> ATTTCCAGGCG
ATTTCCAGGCG -> TTTCCAGGCGC
TTTCCAGGCGC -> TTCCAGGCGCT
TTCCAGGCGCT -> TCCAGGCGCTT
TCCAGGCGCTT -> CCAGGCGCTTA
CCAGGCGCTTA -> CAGGCGCTTAC
CAGGCGCTTAC -> AGGCGCTTACG
AGGCGCTTACG -> GGCGCTTACGC
GGCGCTTACGC -> GCGCTTACGCT
GCGCTTACGCT -> CGCTTACGCTG
CGCTTACGCTG -> GCTTACGCTGA
GCTTACGCTGA -> CTTACGCTGAT
CTTACGCTGAT -> TTACGCTGATC
TTACGCTGATC -> TACGCTGATCT
TACGCTGATCT -> ACGCTGATCTT
ACGCTGATCTT -> CGCTGATCTTA
CGCTGATCTTA -> GCTGATCTTAT
GCTGATCTTAT -> CTGATCTTATC
CTGATCTTATC -> TGATCTTATCG
TGATCTTATCG -> GATCTTATCGA
GATCTTATCGA -> ATCTTATCGAT
ATCTTATCGAT -> TCTTATCGATA
TCTTATCGATA -> CTTATCGATAT
CTTATCGATAT -> TTATCGATATC
TTATCGATATC -> TATCGATATCT
TATCGATATCT -> ATCGATATCTG
ATCGATATCTG -> TCGATATCTGT
TCGATATCTGT -> CGATATCTGTT
CGATATCTGTT -> GATATCTGTTT
GATATCTGTTT -> ATATCTGTTTG
ATATCTGTTTG -> TATCTGTTTGG
TATCTGTTTGG -> ATCTGTTTGGG
ATCTGTTTGGG -> TCTGTTTGGGC
TCTGTTTGGGC -> CTGTTTGGGCA
CTGTTTGGGCA -> TGTTTGGGCAG
TGTTTGGGCAG -> GTTTGGGCAGT
GTTTGGGCAGT -> TTTGGGCAGTC
TTTGGGCAGTC -> TTGGGCAGTCG
TTGGGCAGTCG -> TGGGCAGTCGA
TGGGCAGTCGA -> GGGCAGTCGAT
GGGCAGTCGAT -> GGCAGTCGATG
GGCAGTCGATG -> GCAGTCGATGA
GCAGTCGATGA -> CAGTCGATGAT
CAGTCGATGAT -> AGTCGATGATG
AGTCGATGATG -> GTCGATGATGT
GTCGATGATGT -> TCGATGATGTA
TCGATGATGTA -> CGATGATGTAT
CGATGATGTAT -> GATGATGTATA
GATGATGTATA -> ATGATGTATAC
ATGATGTATAC -> TGATGTATACA
TGATGTATACA -> GATGTATACAA
GATGTATACAA -> ATGTATACAAA
ATGTATACAAA -> TGTATACAAAG
TGTATACAAAG -> GTATACAAAGG
GTATACAAAGG -> TATACAAAGGC
TATACAAAGGC -> ATACAAAGGCT
ATACAAAGGCT -> TACAAAGGCTC
TACAAAGGCTC -> ACAAAGGCTCC
ACAAAGGCTCC -> CAAAGGCTCCG
CAAAGGCTCCG -> AAAGGCTCCGG
AAAGGCTCCGG -> AAGGCTCCGGT
AAGGCTCCGGT -> AGGCTCCGGTA
AGGCTCCGGTA -> GGCTCCGGTAA
GGCTCCGGTAA -> GCTCCGGTAAG
GCTCCGGTAAG -> CTCCGGTAAGC
CTCCGGTAAGC -> TCCGGTAAGCG
TCCGGTAAGCG -> CCGGTAAGCGC
CCGGTAAGCGC -> CGGTAAGCGCC
CGGTAAGCGCC -> GGTAAGCGCCG
GGTAAGCGCCG -> GTAAGCGCCGA
GTAAGCGCCGA -> TAAGCGCCGAC
TAAGCGCCGAC -> AAGCGCCGACC
AAGCGCCGACC -> AGCGCCGACCT
AGCGCCGACCT -> GCGCCGACCTG
GCGCCGACCTG -> CGCCGACCTGA
CGCCGACCTGA -> GCCGACCTGAG
GCCGACCTGAG -> CCGACCTGAGA
CCGACCTGAGA -> CGACCTGAGAG
CGACCTGAGAG -> GACCTGAGAGG
GACCTGAGAGG -> ACCTGAGAGGT
ACCTGAGAGGT -> CCTGAGAGGTG
CCTGAGAGGTG -> CTGAGAGGTGC
CTGAGAGGTGC -> TGAGAGGTGCA
TGAGAGGTGCA -> GAGAGGTGCAG
GAGAGGTGCAG -> AGAGGTGCAGG
AGAGGTGCAGG -> GAGGTGCAGGA
GAGGTGCAGGA -> AGGTGCAGGAG
AGGTGCAGGAG -> GGTGCAGGAGG
GGTGCAGGAGG -> GTGCAGGAGGC
GTGCAGGAGGC -> TGCAGGAGGCC
TGCAGGAGGCC -> GCAGGAGGCCA
GCAGGAGGCCA -> CAGGAGGCCAT
CAGGAGGCCAT -> AGGAGGCCATT
AGGAGGCCATT -> GGAGGCCATTT
GGAGGCCATTT -> GAGGCCATTTG
GAGGCCATTTG -> AGGCCATTTGC
AGGCCATTTGC -> GGCCATTTGCG
GGCCATTTGCG -> GCCATTTGCGA
GCCATTTGCGA -> CCATTTGCGAC
CCATTTGCGAC -> CATTTGCGACG
CATTTGCGACG -> ATTTGCGACGC
ATTTGCGACGC -> TTTGCGACGCT
TTTGCGACGCT -> TTGCGACGCTG
TTGCGACGCTG -> TGCGACGCTGG
TGCGACGCTGG -> GCGACGCTGGC
GCGACGCTGGC -> CGACGCTGGCC
CGACGCTGGCC -> GACGCTGGCCA
GACGCTGGCCA -> ACGCTGGCCAC
ACGCTGGCCAC -> CGCTGGCCACG
CGCTGGCCACG -> GCTGGCCACGA
GCTGGCCACGA -> CTGGCCACGAT
CTGGCCACGAT -> TGGCCACGATT
TGGCCACGATT -> GGCCACGATTG
GGCCACGATTG -> GCCACGATTGT
GCCACGATTGT -> CCACGATTGTT
CCACGATTGTT -> CACGATTGTTT
CACGATTGTTT -> ACGATTGTTTC
ACGATTGTTTC -> CGATTGTTTCG
CGATTGTTTCG -> GATTGTTTCGA
GATTGTTTCGA -> ATTGTTTCGAT
ATTGTTTCGAT -> TTGTTTCGATG
TTGTTTCGATG -> TGTTTCGATGC
TGTTTCGATGC -> GTTTCGATGCG
GTTTCGATGCG -> TTTCGATGCGT
TTTCGATGCGT -> TTCGATGCGTC
TTCGATGCGTC -> TCGATGCGTCC
TCGATGCGTCC -> CGATGCGTCCC
CGATGCGTCCC -> GATGCGTCCCG
GATGCGTCCCG -> ATGCGTCCCGC
ATGCGTCCCGC -> TGCGTCCCGCC
TGCGTCCCGCC -> GCGTCCCGCCC
GCGTCCCGCCC -> CGTCCCGCCCC
CGTCCCGCCCC -> GTCCCGCCCCA
GTCCCGCCCCA -> TCCCGCCCCAG
TCCCGCCCCAG -> CCCGCCCCAGA
CCCGCCCCAGA -> CCGCCCCAGAG
CCGCCCCAGAG -> CGCCCCAGAGG
CGCCCCAGAGG -> GCCCCAGAGGT
GCCCCAGAGGT -> CCCCAGAGGTG
CCCCAGAGGTG -> CCCAGAGGTGT
CCCAGAGGTGT -> CCAGAGGTGTC
CCAGAGGTGTC -> CAGAGGTGTCC
CAGAGGTGTCC -> AGAGGTGTCCA
AGAGGTGTCCA -> GAGGTGTCCAC
GAGGTGTCCAC -> AGGTGTCCACG
AGGTGTCCACG -> GGTGTCCACGT
GGTGTCCACGT -> GTGTCCACGTA
GTGTCCACGTA -> TGTCCACGTAT
TGTCCACGTAT -> GTCCACGTATG
GTCCACGTATG -> TCCACGTATGA
TCCACGTATGA -> CCACGTATGAA
CCACGTATGAA -> CACGTATGAAC
CACGTATGAAC -> ACGTATGAACG
ACGTATGAACG -> CGTATGAACGT
CGTATGAACGT -> GTATGAACGTA
GTATGAACGTA -> TATGAACGTAC
TATGAACGTAC -> ATGAACGTACC
ATGAACGTACC -> TGAACGTACCA
TGAACGTACCA -> GAACGTACCAT
GAACGTACCAT -> AACGTACCATC
AACGTACCATC -> ACGTACCATCG
ACGTACCATCG -> CGTACCATCGG
CGTACCATCGG -> GTACCATCGGT
GTACCATCGGT -> TACCATCGGTG
TACCATCGGTG -> ACCATCGGTGA
ACCATCGGTGA -> CCATCGGTGAT
CCATCGGTGAT -> CATCGGTGATG
CATCGGTGATG -> ATCGGTGATGC
ATCGGTGATGC -> TCGGTGATGCC
TCGGTGATGCC -> CGGTGATGCCA
CGGTGATGCCA -> GGTGATGCCAA
GGTGATGCCAA -> GTGATGCCAAC
GTGATGCCAAC -> TGATGCCAACC
TGATGCCAACC -> GATGCCAACCC
GATGCCAACCC -> ATGCCAACCCG
ATGCCAACCCG -> TGCCAACCCGG
TGCCAACCCGG -> GCCAACCCGGC
GCCAACCCGGC -> CCAACCCGGCT
CCAACCCGGCT -> CAACCCGGCTA
CAACCCGGCTA -> AACCCGGCTAA
AACCCGGCTAA -> ACCCGGCTAAG
ACCCGGCTAAG -> CCCGGCTAAGG
CCCGGCTAAGG -> CCGGCTAAGGC
CCGGCTAAGGC -> CGGCTAAGGCA
CGGCTAAGGCA -> GGCTAAGGCAC
GGCTAAGGCAC -> GCTAAGGCACA
GCTAAGGCACA -> CTAAGGCACAT
CTAAGGCACAT -> TAAGGCACATC
TAAGGCACATC -> AAGGCACATCA
AAGGCACATCA -> AGGCACATCAG
AGGCACATCAG -> GGCACATCAGA
GGCACATCAGA -> GCACATCAGAG
GCACATCAGAG -> CACATCAGAGG
CACATCAGAGG -> ACATCAGAGGC
ACATCAGAGGC -> CATCAGAGGCC
CATCAGAGGCC -> ATCAGAGGCCC
ATCAGAGGCCC -> TCAGAGGCCCG
TCAGAGGCCCG -> CAGAGGCCCGA
CAGAGGCCCGA -> AGAGGCCCGAA
AGAGGCCCGAA -> GAGGCCCGAAT
GAGGCCCGAAT -> AGGCCCGAATG
AGGCCCGAATG -> GGCCCGAATGA
GGCCCGAATGA -> GCCCGAATGAA
GCCCGAATGAA -> CCCGAATGAAA
CCCGAATGAAA -> CCGAATGAAAG
CCGAATGAAAG -> CGAATGAAAGA
CGAATGAAAGA -> GAATGAAAGAT
GAATGAAAGAT -> AATGAAAGATA
AATGAAAGATA -> ATGAAAGATAT
ATGAAAGATAT -> TGAAAGATATA
TGAAAGATATA -> GAAAGATATAC
GAAAGATATAC -> AAAGATATACA
AAAGATATACA -> AAGATATACAC
AAGATATACAC -> AGATATACACA
AGATATACACA -> GATATACACAA
GATATACACAA -> ATATACACAAC
ATATACACAAC -> TATACACAACG
TATACACAACG -> ATACACAACGG
ATACACAACGG -> TACACAACGGT
TACACAACGGT -> ACACAACGGTG
ACACAACGGTG -> CACAACGGTGG
CACAACGGTGG -> ACAACGGTGGC
ACAACGGTGGC -> CAACGGTGGCC
CAACGGTGGCC -> AACGGTGGCCC
AACGGTGGCCC -> ACGGTGGCCCG
ACGGTGGCCCG -> CGGTGGCCCGC
CGGTGGCCCGC -> GGTGGCCCGCT
GGTGGCCCGCT -> GTGGCCCGCTG
GTGGCCCGCTG -> TGGCCCGCTGA
TGGCCCGCTGA -> GGCCCGCTGAT
GGCCCGCTGAT -> GCCCGCTGATG
GCCCGCTGATG -> CCCGCTGATGT
CCCGCTGATGT -> CCGCTGATGTT
CCGCTGATGTT -> CGCTGATGTTA
CGCTGATGTTA -> GCTGATGTTAC
GCTGATGTTAC -> CTGATGTTACC
CTGATGTTACC -> TGATGTTACCG
TGATGTTACCG -> GATGTTACCGC
GATGTTACCGC -> ATGTTACCGCA
ATGTTACCGCA -> TGTTACCGCAG
TGTTACCGCAG -> GTTACCGCAGT
GTTACCGCAGT -> TTACCGCAGTT
TTACCGCAGTT -> TACCGCAGTTT
TACCGCAGTTT -> ACCGCAGTTTG
ACCGCAGTTTG -> CCGCAGTTTGG
CCGCAGTTTGG -> CGCAGTTTGGG
CGCAGTTTGGG -> GCAGTTTGGGG
GCAGTTTGGGG -> CAGTTTGGGGA
CAGTTTGGGGA -> AGTTTGGGGAC
AGTTTGGGGAC -> GTTTGGGGACG
GTTTGGGGACG -> TTTGGGGACGG
TTTGGGGACGG -> TTGGGGACGGG
TTGGGGACGGG -> TGGGGACGGGG
TGGGGACGGGG -> GGGGACGGGGC
GGGGACGGGGC -> GGGACGGGGCG
GGGACGGGGCG -> GGACGGGGCGT
GGACGGGGCGT -> GACGGGGCGTG
GACGGGGCGTG -> ACGGGGCGTGA
ACGGGGCGTGA -> CGGGGCGTGAA
CGGGGCGTGAA -> GGGGCGTGAAT
GGGGCGTGAAT -> GGGCGTGAATG
GGGCGTGAATG -> GGCGTGAATGT
GGCGTGAATGT -> GCGTGAATGTG
GCGTGAATGTG -> CGTGAATGTGG
CGTGAATGTGG -> GTGAATGTGGC
GTGAATGTGGC -> TGAATGTGGCA
TGAATGTGGCA -> GAATGTGGCAC
GAATGTGGCAC -> AATGTGGCACA
AATGTGGCACA -> ATGTGGCACAA
ATGTGGCACAA -> TGTGGCACAAC
TGTGGCACAAC -> GTGGCACAACG
GTGGCACAACG -> TGGCACAACGA
TGGCACAACGA -> GGCACAACGAA
GGCACAACGAA -> GCACAACGAAG
GCACAACGAAG -> CACAACGAAGA
CACAACGAAGA -> ACAACGAAGAC
ACAACGAAGAC -> CAACGAAGACA
CAACGAAGACA -> AACGAAGACAG
AACGAAGACAG -> ACGAAGACAGT
ACGAAGACAGT -> CGAAGACAGTG
CGAAGACAGTG -> GAAGACAGTGC
GAAGACAGTGC -> AAGACAGTGCG
AAGACAGTGCG -> AGACAGTGCGC
AGACAGTGCGC -> GACAGTGCGCG
GACAGTGCGCG -> ACAGTGCGCGT
ACAGTGCGCGT -> CAGTGCGCGTA
CAGTGCGCGTA -> AGTGCGCGTAC
AGTGCGCGTAC -> GTGCGCGTACC
GTGCGCGTACC -> TGCGCGTACCG
TGCGCGTACCG -> GCGCGTACCGA
GCGCGTACCGA -> CGCGTACCGAC
CGCGTACCGAC -> GCGTACCGACT
GCGTACCGACT -> CGTACCGACTG
CGTACCGACTG -> GTACCGACTGA
GTACCGACTGA -> TACCGACTGAG
TACCGACTGAG -> ACCGACTGAGT
ACCGACTGAGT -> CCGACTGAGTC
CCGACTGAGTC -> CGACTGAGTCA
CGACTGAGTCA -> GACTGAGTCAT
GACTGAGTCAT -> ACTGAGTCATA
ACTGAGTCATA -> CTGAGTCATAG
CTGAGTCATAG -> TGAGTCATAGT
TGAGTCATAGT -> GAGTCATAGTC
GAGTCATAGTC -> AGTCATAGTCG
AGTCATAGTCG -> GTCATAGTCGG
GTCATAGTCGG -> TCATAGTCGGC
TCATAGTCGGC -> CATAGTCGGCT
CATAGTCGGCT -> ATAGTCGGCTC
ATAGTCGGCTC -> TAGTCGGCTCC
TAGTCGGCTCC -> AGTCGGCTCCT
AGTCGGCTCCT -> GTCGGCTCCTA
GTCGGCTCCTA -> TCGGCTCCTAA
TCGGCTCCTAA -> CGGCTCCTAAC
CGGCTCCTAAC -> GGCTCCTAACG
GGCTCCTAACG -> GCTCCTAACGA
GCTCCTAACGA -> CTCCTAACGAG
CTCCTAACGAG -> TCCTAACGAGT
TCCTAACGAGT -> CCTAACGAGTT
CCTAACGAGTT -> CTAACGAGTTG
CTAACGAGTTG -> TAACGAGTTGC
TAACGAGTTGC -> AACGAGTTGCG
AACGAGTTGCG -> ACGAGTTGCGC
ACGAGTTGCGC -> CGAGTTGCGCC
CGAGTTGCGCC -> GAGTTGCGCCC
GAGTTGCGCCC -> AGTTGCGCCCG
AGTTGCGCCCG -> GTTGCGCCCGA
GTTGCGCCCGA -> TTGCGCCCGAT
TTGCGCCCGAT -> TGCGCCCGATA
TGCGCCCGATA -> GCGCCCGATAA
GCGCCCGATAA -> CGCCCGATAAG
CGCCCGATAAG -> GCCCGATAAGC
GCCCGATAAGC -> CCCGATAAGCT
CCCGATAAGCT -> CCGATAAGCTG
CCGATAAGCTG -> CGATAAGCTGC
CGATAAGCTGC -> GATAAGCTGCG
GATAAGCTGCG -> ATAAGCTGCGT
ATAAGCTGCGT -> TAAGCTGCGTC
TAAGCTGCGTC -> AAGCTGCGTCT,AAGCTGCGTCC
AAGCTGCGTCT -> AGCTGCGTCTC
AGCTGCGTCTC -> GCTGCGTCTCC
GCTGCGTCTCC -> CTGCGTCTCCC
CTGCGTCTCCC -> TGCGTCTCCCT
TGCGTCTCCCT -> GCGTCTCCCTG
GCGTCTCCCTG -> CGTCTCCCTGT
CGTCTCCCTGT -> GTCTCCCTGTT
GTCTCCCTGTT -> TCTCCCTGTTA
TCTCCCTGTTA -> CTCCCTGTTAG
CTCCCTGTTAG -> TCCCTGTTAGC
TCCCTGTTAGC -> CCCTGTTAGCA
CCCTGTTAGCA -> CCTGTTAGCAC
CCTGTTAGCAC -> CTGTTAGCACC
CTGTTAGCACC -> TGTTAGCACCT
TGTTAGCACCT -> GTTAGCACCTG
GTTAGCACCTG -> TTAGCACCTGT
TTAGCACCTGT -> TAGCACCTGTG
TAGCACCTGTG -> AGCACCTGTGC
AGCACCTGTGC -> GCACCTGTGCG
GCACCTGTGCG -> CACCTGTGCGA
CACCTGTGCGA -> ACCTGTGCGAT
ACCTGTGCGAT -> CCTGTGCGATA
CCTGTGCGATA -> CTGTGCGATAG
CTGTGCGATAG -> TGTGCGATAGT
TGTGCGATAGT -> GTGCGATAGTA
GTGCGATAGTA -> TGCGATAGTAA
TGCGATAGTAA -> GCGATAGTAAC
GCGATAGTAAC -> CGATAGTAACA
CGATAGTAACA -> GATAGTAACAA
GATAGTAACAA -> ATAGTAACAAG
ATAGTAACAAG -> TAGTAACAAGT
TAGTAACAAGT -> AGTAACAAGTT
AGTAACAAGTT -> GTAACAAGTTT
GTAACAAGTTT -> TAACAAGTTTT
TAACAAGTTTT -> AACAAGTTTTT
AACAAGTTTTT -> ACAAGTTTTTT
ACAAGTTTTTT -> CAAGTTTTTTT
CAAGTTTTTTT -> AAGTTTTTTTG
AAGTTTTTTTG -> AGTTTTTTTGG
AGTTTTTTTGG -> GTTTTTTTGGT
GTTTTTTTGGT -> TTTTTTTGGTT
TTTTTTTGGTT -> TTTTTTGGTTT
TTTTTTGGTTT -> TTTTTGGTTTC
TTTTTGGTTTC -> TTTTGGTTTCT
TTTTGGTTTCT -> TTTGGTTTCTT
TTTGGTTTCTT -> TTGGTTTCTTC
TTGGTTTCTTC -> TGGTTTCTTCT
TGGTTTCTTCT -> GGTTTCTTCTA
GGTTTCTTCTA -> GTTTCTTCTAC
GTTTCTTCTAC -> TTTCTTCTACA
TTTCTTCTACA -> TTCTTCTACAT
TTCTTCTACAT -> TCTTCTACATC
TCTTCTACATC -> CTTCTACATCG
CTTCTACATCG -> TTCTACATCGC
TTCTACATCGC -> TCTACATCGCG
TCTACATCGCG -> CTACATCGCGC
CTACATCGCGC -> TACATCGCGCT
TACATCGCGCT -> ACATCGCGCTC
ACATCGCGCTC -> CATCGCGCTCC
CATCGCGCTCC -> ATCGCGCTCCC
ATCGCGCTCCC -> TCGCGCTCCCA
TCGCGCTCCCA -> CGCGCTCCCAA
CGCGCTCCCAA -> GCGCTCCCAAC
GCGCTCCCAAC -> CGCTCCCAACT
CGCTCCCAACT -> GCTCCCAACTC
GCTCCCAACTC -> CTCCCAACTCA
CTCCCAACTCA -> TCCCAACTCAT
TCCCAACTCAT -> CCCAACTCATG
CCCAACTCATG -> CCAACTCATGC
CCAACTCATGC -> CAACTCATGCA
CAACTCATGCA -> AACTCATGCAC
AACTCATGCAC -> ACTCATGCACG
ACTCATGCACG -> CTCATGCACGC
CTCATGCACGC -> TCATGCACGCG
TCATGCACGCG -> CATGCACGCGC
CATGCACGCGC -> ATGCACGCGCG
ATGCACGCGCG -> TGCACGCGCGA
TGCACGCGCGA -> GCACGCGCGAT
GCACGCGCGAT -> CACGCGCGATC
CACGCGCGATC -> ACGCGCGATCG
ACGCGCGATCG -> CGCGCGATCGG
CGCGCGATCGG -> GCGCGATCGGC
GCGCGATCGGC -> CGCGATCGGCA
CGCGATCGGCA -> GCGATCGGCAC
GCGATCGGCAC -> CGATCGGCACA
CGATCGGCACA -> GATCGGCACAA
GATCGGCACAA -> ATCGGCACAAT
ATCGGCACAAT -> TCGGCACAATT
TCGGCACAATT -> CGGCACAATTA
CGGCACAATTA -> GGCACAATTAA
GGCACAATTAA -> GCACAATTAAA
GCACAATTAAA -> CACAATTAAAC
CACAATTAAAC -> ACAATTAAACC
ACAATTAAACC -> CAATTAAACCT
CAATTAAACCT -> AATTAAACCTT
AATTAAACCTT -> ATTAAACCTTT
ATTAAACCTTT -> TTAAACCTTTG
TTAAACCTTTG -> TAAACCTTTGT
TAAACCTTTGT -> AAACCTTTGTC
AAACCTTTGTC -> AACCTTTGTCC
AACCTTTGTCC -> ACCTTTGTCCA
ACCTTTGTCCA -> CCTTTGTCCAC
CCTTTGTCCAC -> CTTTGTCCACA
CTTTGTCCACA -> TTTGTCCACAG
TTTGTCCACAG -> TTGTCCACAGC
TTGTCCACAGC -> TGTCCACAGCT
TGTCCACAGCT -> GTCCACAGCTG
GTCCACAGCTG -> TCCACAGCTGC
TCCACAGCTGC -> CCACAGCTGCG
CCACAGCTGCG -> CACAGCTGCGC
CACAGCTGCGC -> ACAGCTGCGCT
ACAGCTGCGCT -> CAGCTGCGCTA
CAGCTGCGCTA -> AGCTGCGCTAC
AGCTGCGCTAC -> GCTGCGCTACC
GCTGCGCTACC -> CTGCGCTACCT
CTGCGCTACCT -> TGCGCTACCTT
TGCGCTACCTT -> GCGCTACCTTA
GCGCTACCTTA -> CGCTACCTTAG
CGCTACCTTAG -> GCTACCTTAGT
GCTACCTTAGT -> CTACCTTAGTT
CTACCTTAGTT -> TACCTTAGTTG
TACCTTAGTTG -> ACCTTAGTTGG
ACCTTAGTTGG -> CCTTAGTTGGA
CCTTAGTTGGA -> CTTAGTTGGAT
CTTAGTTGGAT -> TTAGTTGGATG
TTAGTTGGATG -> TAGTTGGATGT
TAGTTGGATGT -> AGTTGGATGTT
AGTTGGATGTT -> GTTGGATGTTA
GTTGGATGTTA -> TTGGATGTTAT
TTGGATGTTAT -> TGGATGTTATA
TGGATGTTATA -> GGATGTTATAA
GGATGTTATAA -> GATGTTATAAA
GATGTTATAAA -> ATGTTATAAAA
ATGTTATAAAA -> TGTTATAAAAT
TGTTATAAAAT -> GTTATAAAATC
GTTATAAAATC -> TTATAAAATCA
TTATAAAATCA -> TATAAAATCAC
TATAAAATCAC -> ATAAAATCACA
ATAAAATCACA -> TAAAATCACAC
TAAAATCACAC -> AAAATCACACC
AAAATCACACC -> AAATCACACCC
AAATCACACCC -> AATCACACCCA
AATCACACCCA -> ATCACACCCAG
ATCACACCCAG -> TCACACCCAGA
TCACACCCAGA -> CACACCCAGAG
CACACCCAGAG -> ACACCCAGAGT
ACACCCAGAGT -> CACCCAGAGTG
CACCCAGAGTG -> ACCCAGAGTGC
ACCCAGAGTGC -> CCCAGAGTGCT
CCCAGAGTGCT -> CCAGAGTGCTC
CCAGAGTGCTC -> CAGAGTGCTCC
CAGAGTGCTCC -> AGAGTGCTCCT
AGAGTGCTCCT -> GAGTGCTCCTA
GAGTGCTCCTA -> AGTGCTCCTAT
AGTGCTCCTAT -> GTGCTCCTATT
GTGCTCCTATT -> TGCTCCTATTT
TGCTCCTATTT -> GCTCCTATTTA
GCTCCTATTTA -> CTCCTATTTAA
CTCCTATTTAA -> TCCTATTTAAA
TCCTATTTAAA -> CCTATTTAAAG
CCTATTTAAAG -> CTATTTAAAGA
CTATTTAAAGA -> TATTTAAAGAG
TATTTAAAGAG -> ATTTAAAGAGT
ATTTAAAGAGT -> TTTAAAGAGTA
TTTAAAGAGTA -> TTAAAGAGTAT
TTAAAGAGTAT -> TAAAGAGTATC
TAAAGAGTATC -> AAAGAGTATCT
AAAGAGTATCT -> AAGAGTATCTA
AAGAGTATCTA -> AGAGTATCTAC
AGAGTATCTAC -> GAGTATCTACG
GAGTATCTACG -> AGTATCTACGT
AGTATCTACGT -> GTATCTACGTC
GTATCTACGTC -> TATCTACGTCA
TATCTACGTCA -> ATCTACGTCAC
ATCTACGTCAC -> TCTACGTCACC
TCTACGTCACC -> CTACGTCACCT
CTACGTCACCT -> TACGTCACCTT
TACGTCACCTT -> ACGTCACCTTG
ACGTCACCTTG -> CGTCACCTTGC
CGTCACCTTGC -> GTCACCTTGCA
GTCACCTTGCA -> TCACCTTGCAA
TCACCTTGCAA -> CACCTTGCAAG
CACCTTGCAAG -> ACCTTGCAAGG
ACCTTGCAAGG -> CCTTGCAAGGC
CCTTGCAAGGC -> CTTGCAAGGCC
CTTGCAAGGCC -> TTGCAAGGCCT
TTGCAAGGCCT -> TGCAAGGCCTG
TGCAAGGCCTG -> GCAAGGCCTGT
GCAAGGCCTGT -> CAAGGCCTGTT
CAAGGCCTGTT -> AAGGCCTGTTA
AAGGCCTGTTA -> AGGCCTGTTAT
AGGCCTGTTAT -> GGCCTGTTATT
GGCCTGTTATT -> GCCTGTTATTT
GCCTGTTATTT -> CCTGTTATTTC
CCTGTTATTTC -> CTGTTATTTCT
CTGTTATTTCT -> TGTTATTTCTC
TGTTATTTCTC -> GTTATTTCTCG
GTTATTTCTCG -> TTATTTCTCGC
TTATTTCTCGC -> TATTTCTCGCT
TATTTCTCGCT -> ATTTCTCGCTC
ATTTCTCGCTC -> TTTCTCGCTCT
TTTCTCGCTCT -> TTCTCGCTCTT
TTCTCGCTCTT -> TCTCGCTCTTA
TCTCGCTCTTA -> CTCGCTCTTAA
CTCGCTCTTAA -> TCGCTCTTAAT
TCGCTCTTAAT -> CGCTCTTAATC
CGCTCTTAATC -> GCTCTTAATCT
GCTCTTAATCT -> CTCTTAATCTG
CTCTTAATCTG -> TCTTAATCTGG
TCTTAATCTGG -> CTTAATCTGGC
CTTAATCTGGC -> TTAATCTGGCT
TTAATCTGGCT -> TAATCTGGCTA
TAATCTGGCTA -> AATCTGGCTAC
AATCTGGCTAC -> ATCTGGCTACT
ATCTGGCTACT -> TCTGGCTACTG
TCTGGCTACTG -> CTGGCTACTGG
CTGGCTACTGG -> TGGCTACTGGG
TGGCTACTGGG -> GGCTACTGGGG
GGCTACTGGGG -> GCTACTGGGGA
GCTACTGGGGA -> CTACTGGGGAC
CTACTGGGGAC -> TACTGGGGACG
TACTGGGGACG -> ACTGGGGACGT
ACTGGGGACGT -> CTGGGGACGTC
CTGGGGACGTC -> TGGGGACGTCA
TGGGGACGTCA -> GGGGACGTCAT
GGGGACGTCAT -> GGGACGTCATC
GGGACGTCATC -> GGACGTCATCG
GGACGTCATCG -> GACGTCATCGT
GACGTCATCGT -> ACGTCATCGTG
ACGTCATCGTG -> CGTCATCGTGA
CGTCATCGTGA -> GTCATCGTGAA
GTCATCGTGAA -> TCATCGTGAAT
TCATCGTGAAT -> CATCGTGAATT
CATCGTGAATT -> ATCGTGAATTT
ATCGTGAATTT -> TCGTGAATTTA
TCGTGAATTTA -> CGTGAATTTAA
CGTGAATTTAA -> GTGAATTTAAT
GTGAATTTAAT -> TGAATTTAATT
TGAATTTAATT -> GAATTTAATTG
GAATTTAATTG -> AATTTAATTGT
AATTTAATTGT -> ATTTAATTGTA
ATTTAATTGTA -> TTTAATTGTAG
TTTAATTGTAG -> TTAATTGTAGC
TTAATTGTAGC -> TAATTGTAGCA
TAATTGTAGCA -> AATTGTAGCAG
AATTGTAGCAG -> ATTGTAGCAGC
ATTGTAGCAGC -> TTGTAGCAGCA
TTGTAGCAGCA -> TGTAGCAGCAA
TGTAGCAGCAA -> GTAGCAGCAAG
GTAGCAGCAAG -> TAGCAGCAAGC
TAGCAGCAAGC -> AGCAGCAAGCA
AGCAGCAAGCA -> GCAGCAAGCAG
GCAGCAAGCAG -> CAGCAAGCAGT
CAGCAAGCAGT -> AGCAAGCAGTG
AGCAAGCAGTG -> GCAAGCAGTGG
GCAAGCAGTGG -> CAAGCAGTGGT
CAAGCAGTGGT -> AAGCAGTGGTC
AAGCAGTGGTC -> AGCAGTGGTCC
AGCAGTGGTCC -> GCAGTGGTCCA
GCAGTGGTCCA -> CAGTGGTCCAA
CAGTGGTCCAA -> AGTGGTCCAAT
AGTGGTCCAAT -> GTGGTCCAATC
GTGGTCCAATC -> TGGTCCAATCG
TGGTCCAATCG -> GGTCCAATCGG
GGTCCAATCGG -> GTCCAATCGGT
GTCCAATCGGT -> TCCAATCGGTT
TCCAATCGGTT -> CCAATCGGTTG
CCAATCGGTTG -> CAATCGGTTGT
CAATCGGTTGT -> AATCGGTTGTT
AATCGGTTGTT -> ATCGGTTGTTC
ATCGGTTGTTC -> TCGGTTGTTCA
TCGGTTGTTCA -> CGGTTGTTCAA
CGGTTGTTCAA -> GGTTGTTCAAT
GGTTGTTCAAT -> GTTGTTCAATT
GTTGTTCAATT -> TTGTTCAATTC
TTGTTCAATTC -> TGTTCAATTCC
TGTTCAATTCC -> GTTCAATTCCT
GTTCAATTCCT -> TTCAATTCCTA
TTCAATTCCTA -> TCAATTCCTAC
TCAATTCCTAC -> CAATTCCTACC
CAATTCCTACC -> AATTCCTACCA
AATTCCTACCA -> ATTCCTACCAC
ATTCCTACCAC -> TTCCTACCACT
TTCCTACCACT -> TCCTACCACTT
TCCTACCACTT -> CCTACCACTTC
CCTACCACTTC -> CTACCACTTCT
CTACCACTTCT -> TACCACTTCTA
TACCACTTCTA -> ACCACTTCTAA
ACCACTTCTAA -> CCACTTCTAAG
CCACTTCTAAG -> CACTTCTAAGC
CACTTCTAAGC -> ACTTCTAAGCG
ACTTCTAAGCG -> CTTCTAAGCGT
CTTCTAAGCGT -> TTCTAAGCGTT
TTCTAAGCGTT -> TCTAAGCGTTT
TCTAAGCGTTT -> CTAAGCGTTTC
CTAAGCGTTTC -> TAAGCGTTTCC
TAAGCGTTTCC -> AAGCGTTTCCA
AAGCGTTTCCA -> AGCGTTTCCAA
AGCGTTTCCAA -> GCGTTTCCAAT
GCGTTTCCAAT -> CGTTTCCAATA
CGTTTCCAATA -> GTTTCCAATAT
GTTTCCAATAT -> TTTCCAATATG
TTTCCAATATG -> TTCCAATATGG
TTCCAATATGG -> TCCAATATGGG
TCCAATATGGG -> CCAATATGGGC
CCAATATGGGC -> CAATATGGGCA
CAATATGGGCA -> AATATGGGCAG
AATATGGGCAG -> ATATGGGCAGA
ATATGGGCAGA -> TATGGGCAGAA
TATGGGCAGAA -> ATGGGCAGAAG
ATGGGCAGAAG -> TGGGCAGAAGG
TGGGCAGAAGG -> GGGCAGAAGGC
GGGCAGAAGGC -> GGCAGAAGGCC
GGCAGAAGGCC -> GCAGAAGGCCT
GCAGAAGGCCT -> CAGAAGGCCTA
CAGAAGGCCTA -> AGAAGGCCTAC
AGAAGGCCTAC -> GAAGGCCTACG
GAAGGCCTACG -> AAGGCCTACGG
AAGGCCTACGG -> AGGCCTACGGA
AGGCCTACGGA -> GGCCTACGGAA
GGCCTACGGAA -> GCCTACGGAAT
GCCTACGGAAT -> CCTACGGAATG
CCTACGGAATG -> CTACGGAATGA
CTACGGAATGA -> TACGGAATGAC
TACGGAATGAC -> ACGGAATGACT
ACGGAATGACT -> CGGAATGACTA
CGGAATGACTA -> GGAATGACTAA
GGAATGACTAA -> GAATGACTAAG
GAATGACTAAG -> AATGACTAAGC
AATGACTAAGC -> ATGACTAAGCT
ATGACTAAGCT -> TGACTAAGCTG
TGACTAAGCTG -> GACTAAGCTGC
GACTAAGCTGC -> ACTAAGCTGCG
ACTAAGCTGCG -> CTAAGCTGCGT
CTAAGCTGCGT -> TAAGCTGCGTC
AAGCTGCGTCC -> AGCTGCGTCCA
AGCTGCGTCCA -> GCTGCGTCCAT
GCTGCGTCCAT -> CTGCGTCCATG
CTGCGTCCATG -> TGCGTCCATGG
TGCGTCCATGG -> GCGTCCATGGG
GCGTCCATGGG -> CGTCCATGGGT
CGTCCATGGGT -> GTCCATGGGTA
GTCCATGGGTA -> TCCATGGGTAC
TCCATGGGTAC -> CCATGGGTACC
CCATGGGTACC -> CATGGGTACCA
CATGGGTACCA -> ATGGGTACCAC
ATGGGTACCAC -> TGGGTACCACG
TGGGTACCACG -> GGGTACCACGT
GGGTACCACGT -> GGTACCACGTC
GGTACCACGTC -> GTACCACGTCG
GTACCACGTCG -> TACCACGTCGG
TACCACGTCGG -> ACCACGTCGGG
ACCACGTCGGG -> CCACGTCGGGC
CCACGTCGGGC -> CACGTCGGGCA
CACGTCGGGCA -> ACGTCGGGCAG
ACGTCGGGCAG -> CGTCGGGCAGA
CGTCGGGCAGA -> GTCGGGCAGAC
GTCGGGCAGAC -> TCGGGCAGACT
TCGGGCAGACT -> CGGGCAGACTC
CGGGCAGACTC -> GGGCAGACTCC
GGGCAGACTCC -> GGCAGACTCCT
GGCAGACTCCT -> GCAGACTCCTG
GCAGACTCCTG -> CAGACTCCTGG
CAGACTCCTGG -> AGACTCCTGGG
AGACTCCTGGG -> GACTCCTGGGA
GACTCCTGGGA -> ACTCCTGGGAT
ACTCCTGGGAT -> CTCCTGGGATA
CTCCTGGGATA -> TCCTGGGATAA
TCCTGGGATAA -> CCTGGGATAAG
CCTGGGATAAG -> CTGGGATAAGT
CTGGGATAAGT -> TGGGATAAGTC
TGGGATAAGTC -> GGGATAAGTCC
GGGATAAGTCC -> GGATAAGTCCT
GGATAAGTCCT -> GATAAGTCCTC
GATAAGTCCTC -> ATAAGTCCTCT
ATAAGTCCTCT -> TAAGTCCTCTC
TAAGTCCTCTC -> AAGTCCTCTCC
AAGTCCTCTCC -> AGTCCTCTCCG
AGTCCTCTCCG -> GTCCTCTCCGA
GTCCTCTCCGA -> TCCTCTCCGAG
TCCTCTCCGAG -> CCTCTCCGAGA
CCTCTCCGAGA -> CTCTCCGAGAA
CTCTCCGAGAA -> TCTCCGAGAAT
TCTCCGAGAAT -> CTCCGAGAATT
CTCCGAGAATT -> TCCGAGAATTT
TCCGAGAATTT -> CCGAGAATTTT
CCGAGAATTTT -> CGAGAATTTTC
CGAGAATTTTC -> GAGAATTTTCG
GAGAATTTTCG -> AGAATTTTCGC
AGAATTTTCGC -> GAATTTTCGCT
GAATTTTCGCT -> AATTTTCGCTG
AATTTTCGCTG -> ATTTTCGCTGA
ATTTTCGCTGA -> TTTTCGCTGAC
TTTTCGCTGAC -> TTTCGCTGACA
TTTCGCTGACA -> TTCGCTGACAA
TTCGCTGACAA -> TCGCTGACAAG
TCGCTGACAAG -> CGCTGACAAGT
CGCTGACAAGT -> GCTGACAAGTG
GCTGACAAGTG -> CTGACAAGTGC
CTGACAAGTGC -> TGACAAGTGCA
TGACAAGTGCA -> GACAAGTGCAC
GACAAGTGCAC -> ACAAGTGCACG
ACAAGTGCACG -> CAAGTGCACGA
CAAGTGCACGA -> AAGTGCACGAC
AAGTGCACGAC -> AGTGCACGACA
AGTGCACGACA -> GTGCACGACAA
GTGCACGACAA -> TGCACGACAAA
TGCACGACAAA -> GCACGACAAAT
GCACGACAAAT -> CACGACAAATT
CACGACAAATT -> ACGACAAATTC
ACGACAAATTC -> CGACAAATTCC
CGACAAATTCC -> GACAAATTCCC
GACAAATTCCC -> ACAAATTCCCA
ACAAATTCCCA -> CAAATTCCCAA
CAAATTCCCAA -> AAATTCCCAAT
AAATTCCCAAT -> AATTCCCAATA
AATTCCCAATA -> ATTCCCAATAA
ATTCCCAATAA -> TTCCCAATAAG
TTCCCAATAAG -> TCCCAATAAGA
TCCCAATAAGA -> CCCAATAAGAA
CCCAATAAGAA -> CCAATAAGAAT
CCAATAAGAAT -> CAATAAGAATC
CAATAAGAATC -> AATAAGAATCG
AATAAGAATCG -> ATAAGAATCGG
ATAAGAATCGG -> TAAGAATCGGG
TAAGAATCGGG -> AAGAATCGGGC
AAGAATCGGGC -> AGAATCGGGCC
AGAATCGGGCC -> GAATCGGGCCC
GAATCGGGCCC -> AATCGGGCCCA
AATCGGGCCCA -> ATCGGGCCCAT
ATCGGGCCCAT -> TCGGGCCCATT
TCGGGCCCATT -> CGGGCCCATTC
CGGGCCCATTC -> GGGCCCATTCC
GGGCCCATTCC -> GGCCCATTCCG
GGCCCATTCCG -> GCCCATTCCGG
GCCCATTCCGG -> CCCATTCCGGT
CCCATTCCGGT -> CCATTCCGGTT
CCATTCCGGTT -> CATTCCGGTTA
CATTCCGGTTA -> ATTCCGGTTAA
ATTCCGGTTAA -> TTCCGGTTAAT
TTCCGGTTAAT -> TCCGGTTAATC
TCCGGTTAATC -> CCGGTTAATCG
CCGGTTAATCG -> CGGTTAATCGT
CGGTTAATCGT -> GGTTAATCGTA
GGTTAATCGTA -> GTTAATCGTAG
GTTAATCGTAG -> TTAATCGTAGC
TTAATCGTAGC -> TAATCGTAGCC
TAATCGTAGCC -> AATCGTAGCCC
AATCGTAGCCC -> ATCGTAGCCCT
ATCGTAGCCCT -> TCGTAGCCCTC
TCGTAGCCCTC -> CGTAGCCCTCT
CGTAGCCCTCT -> GTAGCCCTCTG
GTAGCCCTCTG -> TAGCCCTCTGG
TAGCCCTCTGG -> AGCCCTCTGGG
AGCCCTCTGGG -> GCCCTCTGGGC
GCCCTCTGGGC -> CCCTCTGGGCT
CCCTCTGGGCT -> CCTCTGGGCTT
CCTCTGGGCTT -> CTCTGGGCTTT
CTCTGGGCTTT -> TCTGGGCTTTA
TCTGGGCTTTA -> CTGGGCTTTAG
CTGGGCTTTAG -> TGGGCTTTAGA
TGGGCTTTAGA -> GGGCTTTAGAA
GGGCTTTAGAA -> GGCTTTAGAAC
GGCTTTAGAAC -> GCTTTAGAACT
GCTTTAGAACT -> CTTTAGAACTC
CTTTAGAACTC -> TTTAGAACTCG
TTTAGAACTCG -> TTAGAACTCGC
TTAGAACTCGC -> TAGAACTCGCG
TAGAACTCGCG -> AGAACTCGCGC
AGAACTCGCGC -> GAACTCGCGCG
GAACTCGCGCG -> AACTCGCGCGC
AACTCGCGCGC -> ACTCGCGCGCA
ACTCGCGCGCA -> CTCGCGCGCAC
CTCGCGCGCAC -> TCGCGCGCACC
TCGCGCGCACC -> CGCGCGCACCC
CGCGCGCACCC -> GCGCGCACCCG
GCGCGCACCCG -> CGCGCACCCGC
CGCGCACCCGC -> GCGCACCCGCG
GCGCACCCGCG -> CGCACCCGCGC
CGCACCCGCGC -> GCACCCGCGCA
GCACCCGCGCA -> CACCCGCGCAG
CACCCGCGCAG -> ACCCGCGCAGT
ACCCGCGCAGT -> CCCGCGCAGTT
CCCGCGCAGTT -> CCGCGCAGTTA
CCGCGCAGTTA -> CGCGCAGTTAA
CGCGCAGTTAA -> GCGCAGTTAAT
GCGCAGTTAAT -> CGCAGTTAATA
CGCAGTTAATA -> GCAGTTAATAT
GCAGTTAATAT -> CAGTTAATATG
CAGTTAATATG -> AGTTAATATGC
AGTTAATATGC -> GTTAATATGCA
GTTAATATGCA -> TTAATATGCAC
TTAATATGCAC -> TAATATGCACG
TAATATGCACG -> AATATGCACGA
AATATGCACGA -> ATATGCACGAT,ATATGCACGAC
ATATGCACGAT -> TATGCACGATT
TATGCACGATT -> ATGCACGATTT
ATGCACGATTT -> TGCACGATTTG
TGCACGATTTG -> GCACGATTTGA
GCACGATTTGA -> CACGATTTGAG
CACGATTTGAG -> ACGATTTGAGT
ACGATTTGAGT -> CGATTTGAGTA
CGATTTGAGTA -> GATTTGAGTAG
GATTTGAGTAG -> ATTTGAGTAGC
ATTTGAGTAGC -> TTTGAGTAGCT
TTTGAGTAGCT -> TTGAGTAGCTT
TTGAGTAGCTT -> TGAGTAGCTTG
TGAGTAGCTTG -> GAGTAGCTTGT
GAGTAGCTTGT -> AGTAGCTTGTA
AGTAGCTTGTA -> GTAGCTTGTAT
GTAGCTTGTAT -> TAGCTTGTATG
TAGCTTGTATG -> AGCTTGTATGT
AGCTTGTATGT -> GCTTGTATGTT
GCTTGTATGTT -> CTTGTATGTTC
CTTGTATGTTC -> TTGTATGTTCA
TTGTATGTTCA -> TGTATGTTCAA
TGTATGTTCAA -> GTATGTTCAAA
GTATGTTCAAA -> TATGTTCAAAC
TATGTTCAAAC -> ATGTTCAAACT
ATGTTCAAACT -> TGTTCAAACTG
TGTTCAAACTG -> GTTCAAACTGG
GTTCAAACTGG -> TTCAAACTGGT
TTCAAACTGGT -> TCAAACTGGTA
TCAAACTGGTA -> CAAACTGGTAA
CAAACTGGTAA -> AAACTGGTAAT
AAACTGGTAAT -> AACTGGTAATC
AACTGGTAATC -> ACTGGTAATCC
ACTGGTAATCC -> CTGGTAATCCC
CTGGTAATCCC -> TGGTAATCCCC
TGGTAATCCCC -> GGTAATCCCCT
GGTAATCCCCT -> GTAATCCCCTC
GTAATCCCCTC -> TAATCCCCTCT
TAATCCCCTCT -> AATCCCCTCTA
AATCCCCTCTA -> ATCCCCTCTAT
ATCCCCTCTAT -> TCCCCTCTATC
TCCCCTCTATC -> CCCCTCTATCA
CCCCTCTATCA -> CCCTCTATCAA
CCCTCTATCAA -> CCTCTATCAAC
CCTCTATCAAC -> CTCTATCAACC
CTCTATCAACC -> TCTATCAACCG
TCTATCAACCG -> CTATCAACCGA
CTATCAACCGA -> TATCAACCGAC
TATCAACCGAC -> ATCAACCGACT
ATCAACCGACT -> TCAACCGACTA
TCAACCGACTA -> CAACCGACTAA
CAACCGACTAA -> AACCGACTAAT
AACCGACTAAT -> ACCGACTAATG
ACCGACTAATG -> CCGACTAATGT
CCGACTAATGT -> CGACTAATGTT
CGACTAATGTT -> GACTAATGTTT
GACTAATGTTT -> ACTAATGTTTC
ACTAATGTTTC -> CTAATGTTTCG
CTAATGTTTCG -> TAATGTTTCGC
TAATGTTTCGC -> AATGTTTCGCT
AATGTTTCGCT -> ATGTTTCGCTT
ATGTTTCGCTT -> TGTTTCGCTTT
TGTTTCGCTTT -> GTTTCGCTTTT
GTTTCGCTTTT -> TTTCGCTTTTG
TTTCGCTTTTG -> TTCGCTTTTGA
TTCGCTTTTGA -> TCGCTTTTGAT
TCGCTTTTGAT -> CGCTTTTGATT
CGCTTTTGATT -> GCTTTTGATTT
GCTTTTGATTT -> CTTTTGATTTC
CTTTTGATTTC -> TTTTGATTTCT
TTTTGATTTCT -> TTTGATTTCTA
TTTGATTTCTA -> TTGATTTCTAG
TTGATTTCTAG -> TGATTTCTAGT
TGATTTCTAGT -> GATTTCTAGTT
GATTTCTAGTT -> ATTTCTAGTTC
ATTTCTAGTTC -> TTTCTAGTTCG
TTTCTAGTTCG -> TTCTAGTTCGA
TTCTAGTTCGA -> TCTAGTTCGAT
TCTAGTTCGAT -> CTAGTTCGATT
CTAGTTCGATT -> TAGTTCGATTG
TAGTTCGATTG -> AGTTCGATTGA
AGTTCGATTGA -> GTTCGATTGAT
GTTCGATTGAT -> TTCGATTGATC
TTCGATTGATC -> TCGATTGATCG
TCGATTGATCG -> CGATTGATCGT
CGATTGATCGT -> GATTGATCGTA
GATTGATCGTA -> ATTGATCGTAT
ATTGATCGTAT -> TTGATCGTATA
TTGATCGTATA -> TGATCGTATAT
TGATCGTATAT -> GATCGTATATC
GATCGTATATC -> ATCGTATATCA
ATCGTATATCA -> TCGTATATCAA
TCGTATATCAA -> CGTATATCAAT
CGTATATCAAT -> GTATATCAATA
GTATATCAATA -> TATATCAATAT
TATATCAATAT -> ATATCAATATT
ATATCAATATT -> TATCAATATTG
TATCAATATTG -> ATCAATATTGG
ATCAATATTGG -> TCAATATTGGG
TCAATATTGGG -> CAATATTGGGT
CAATATTGGGT -> AATATTGGGTT
AATATTGGGTT -> ATATTGGGTTT
ATATTGGGTTT -> TATTGGGTTTG
TATTGGGTTTG -> ATTGGGTTTGC
ATTGGGTTTGC -> TTGGGTTTGCC
TTGGGTTTGCC -> TGGGTTTGCCC
TGGGTTTGCCC -> GGGTTTGCCCG
GGGTTTGCCCG -> GGTTTGCCCGG
GGTTTGCCCGG -> GTTTGCCCGGT
GTTTGCCCGGT -> TTTGCCCGGTG
TTTGCCCGGTG -> TTGCCCGGTGG
TTGCCCGGTGG -> TGCCCGGTGGC
TGCCCGGTGGC -> GCCCGGTGGCT
GCCCGGTGGCT -> CCCGGTGGCTT
CCCGGTGGCTT -> CCGGTGGCTTA
CCGGTGGCTTA -> CGGTGGCTTAC
CGGTGGCTTAC -> GGTGGCTTACG
GGTGGCTTACG -> GTGGCTTACGT
GTGGCTTACGT -> TGGCTTACGTG
TGGCTTACGTG -> GGCTTACGTGA
GGCTTACGTGA -> GCTTACGTGAT
GCTTACGTGAT -> CTTACGTGATC
CTTACGTGATC -> TTACGTGATCG
TTACGTGATCG -> TACGTGATCGA
TACGTGATCGA -> ACGTGATCGAT
ACGTGATCGAT -> CGTGATCGATG
CGTGATCGATG -> GTGATCGATGC
GTGATCGATGC -> TGATCGATGCC
TGATCGATGCC -> GATCGATGCCA
GATCGATGCCA -> ATCGATGCCAA
ATCGATGCCAA -> TCGATGCCAAG
TCGATGCCAAG -> CGATGCCAAGG
CGATGCCAAGG -> GATGCCAAGGA
GATGCCAAGGA -> ATGCCAAGGAA
ATGCCAAGGAA -> TGCCAAGGAAA
TGCCAAGGAAA -> GCCAAGGAAAG
GCCAAGGAAAG -> CCAAGGAAAGG
CCAAGGAAAGG -> CAAGGAAAGGA
CAAGGAAAGGA -> AAGGAAAGGAA
AAGGAAAGGAA -> AGGAAAGGAAC
AGGAAAGGAAC -> GGAAAGGAACA
GGAAAGGAACA -> GAAAGGAACAA
GAAAGGAACAA -> AAAGGAACAAC
AAAGGAACAAC -> AAGGAACAACC
AAGGAACAACC -> AGGAACAACCC
AGGAACAACCC -> GGAACAACCCC
GGAACAACCCC -> GAACAACCCCA
GAACAACCCCA -> AACAACCCCAT
AACAACCCCAT -> ACAACCCCATT
ACAACCCCATT -> CAACCCCATTA
CAACCCCATTA -> AACCCCATTAC
AACCCCATTAC -> ACCCCATTACG
ACCCCATTACG -> CCCCATTACGG
CCCCATTACGG -> CCCATTACGGT
CCCATTACGGT -> CCATTACGGTG
CCATTACGGTG -> CATTACGGTGG
CATTACGGTGG -> ATTACGGTGGG
ATTACGGTGGG -> TTACGGTGGGT
TTACGGTGGGT -> TACGGTGGGTG
TACGGTGGGTG -> ACGGTGGGTGA
ACGGTGGGTGA -> CGGTGGGTGAA
CGGTGGGTGAA -> GGTGGGTGAAA
GGTGGGTGAAA -> GTGGGTGAAAT
GTGGGTGAAAT -> TGGGTGAAATT
TGGGTGAAATT -> GGGTGAAATTG
GGGTGAAATTG -> GGTGAAATTGG
GGTGAAATTGG -> GTGAAATTGGT
GTGAAATTGGT -> TGAAATTGGTC
TGAAATTGGTC -> GAAATTGGTCA
GAAATTGGTCA -> AAATTGGTCAC
AAATTGGTCAC -> AATTGGTCACG
AATTGGTCACG -> ATTGGTCACGA
ATTGGTCACGA -> TTGGTCACGAC
TTGGTCACGAC -> TGGTCACGACT
TGGTCACGACT -> GGTCACGACTG
GGTCACGACTG -> GTCACGACTGG
GTCACGACTGG -> TCACGACTGGG
TCACGACTGGG -> CACGACTGGGG
CACGACTGGGG -> ACGACTGGGGG
ACGACTGGGGG -> CGACTGGGGGT
CGACTGGGGGT -> GACTGGGGGTG
GACTGGGGGTG -> ACTGGGGGTGC
ACTGGGGGTGC -> CTGGGGGTGCT
CTGGGGGTGCT -> TGGGGGTGCTA
TGGGGGTGCTA -> GGGGGTGCTAG
GGGGGTGCTAG -> GGGGTGCTAGC
GGGGTGCTAGC -> GGGTGCTAGCA
GGGTGCTAGCA -> GGTGCTAGCAG
GGTGCTAGCAG -> GTGCTAGCAGC
GTGCTAGCAGC -> TGCTAGCAGCA
TGCTAGCAGCA -> GCTAGCAGCAC
GCTAGCAGCAC -> CTAGCAGCACG
CTAGCAGCACG -> TAGCAGCACGG
TAGCAGCACGG -> AGCAGCACGGT
AGCAGCACGGT -> GCAGCACGGTC
GCAGCACGGTC -> CAGCACGGTCT
CAGCACGGTCT -> AGCACGGTCTA
AGCACGGTCTA -> GCACGGTCTAT
GCACGGTCTAT -> CACGGTCTATC
CACGGTCTATC -> ACGGTCTATCG
ACGGTCTATCG -> CGGTCTATCGG
CGGTCTATCGG -> GGTCTATCGGT
GGTCTATCGGT -> GTCTATCGGTC
GTCTATCGGTC -> TCTATCGGTCA
TCTATCGGTCA -> CTATCGGTCAC
CTATCGGTCAC -> TATCGGTCACC
TATCGGTCACC -> ATCGGTCACCC
ATCGGTCACCC -> TCGGTCACCCT
TCGGTCACCCT -> CGGTCACCCTA
CGGTCACCCTA -> GGTCACCCTAA
GGTCACCCTAA -> GTCACCCTAAT
GTCACCCTAAT -> TCACCCTAATG
TCACCCTAATG -> CACCCTAATGA
CACCCTAATGA -> ACCCTAATGAT
ACCCTAATGAT -> CCCTAATGATG
CCCTAATGATG -> CCTAATGATGG
CCTAATGATGG -> CTAATGATGGG
CTAATGATGGG -> TAATGATGGGC
TAATGATGGGC -> AATGATGGGCA
AATGATGGGCA -> ATGATGGGCAC
ATGATGGGCAC -> TGATGGGCACT
TGATGGGCACT -> GATGGGCACTC
GATGGGCACTC -> ATGGGCACTCC
ATGGGCACTCC -> TGGGCACTCCA
TGGGCACTCCA -> GGGCACTCCAC
GGGCACTCCAC -> GGCACTCCACT
GGCACTCCACT -> GCACTCCACTC
GCACTCCACTC -> CACTCCACTCT
CACTCCACTCT -> ACTCCACTCTT
ACTCCACTCTT -> CTCCACTCTTG
CTCCACTCTTG -> TCCACTCTTGG
TCCACTCTTGG -> CCACTCTTGGG
CCACTCTTGGG -> CACTCTTGGGG
CACTCTTGGGG -> ACTCTTGGGGG
ACTCTTGGGGG -> CTCTTGGGGGT
CTCTTGGGGGT -> TCTTGGGGGTC
TCTTGGGGGTC -> CTTGGGGGTCT
CTTGGGGGTCT -> TTGGGGGTCTT
TTGGGGGTCTT -> TGGGGGTCTTC
TGGGGGTCTTC -> GGGGGTCTTCC
GGGGGTCTTCC -> GGGGTCTTCCG
GGGGTCTTCCG -> GGGTCTTCCGC
GGGTCTTCCGC -> GGTCTTCCGCT
GGTCTTCCGCT -> GTCTTCCGCTA
GTCTTCCGCTA -> TCTTCCGCTAG
TCTTCCGCTAG -> CTTCCGCTAGA
CTTCCGCTAGA -> TTCCGCTAGAG
TTCCGCTAGAG -> TCCGCTAGAGC
TCCGCTAGAGC -> CCGCTAGAGCG
CCGCTAGAGCG -> CGCTAGAGCGG
CGCTAGAGCGG -> GCTAGAGCGGT
GCTAGAGCGGT -> CTAGAGCGGTT
CTAGAGCGGTT -> TAGAGCGGTTT
TAGAGCGGTTT -> AGAGCGGTTTT
AGAGCGGTTTT -> GAGCGGTTTTG
GAGCGGTTTTG -> AGCGGTTTTGC
AGCGGTTTTGC -> GCGGTTTTGCC
GCGGTTTTGCC -> CGGTTTTGCCG
CGGTTTTGCCG -> GGTTTTGCCGC
GGTTTTGCCGC -> GTTTTGCCGCT
GTTTTGCCGCT -> TTTTGCCGCTG
TTTTGCCGCTG -> TTTGCCGCTGC
TTTGCCGCTGC -> TTGCCGCTGCG
TTGCCGCTGCG -> TGCCGCTGCGC
TGCCGCTGCGC -> GCCGCTGCGCC
GCCGCTGCGCC -> CCGCTGCGCCT
CCGCTGCGCCT -> CGCTGCGCCTG
CGCTGCGCCTG -> GCTGCGCCTGG
GCTGCGCCTGG -> CTGCGCCTGGC
CTGCGCCTGGC -> TGCGCCTGGCC
TGCGCCTGGCC -> GCGCCTGGCCA
GCGCCTGGCCA -> CGCCTGGCCAA
CGCCTGGCCAA -> GCCTGGCCAAA
GCCTGGCCAAA -> CCTGGCCAAAT
CCTGGCCAAAT -> CTGGCCAAATC
CTGGCCAAATC -> TGGCCAAATCT
TGGCCAAATCT -> GGCCAAATCTG
GGCCAAATCTG -> GCCAAATCTGC
GCCAAATCTGC -> CCAAATCTGCA
CCAAATCTGCA -> CAAATCTGCAG
CAAATCTGCAG -> AAATCTGCAGT
AAATCTGCAGT -> AATCTGCAGTG
AATCTGCAGTG -> ATCTGCAGTGA
ATCTGCAGTGA -> TCTGCAGTGAT
TCTGCAGTGAT -> CTGCAGTGATA
CTGCAGTGATA -> TGCAGTGATAT
TGCAGTGATAT -> GCAGTGATATA
GCAGTGATATA -> CAGTGATATAT
CAGTGATATAT -> AGTGATATATT
AGTGATATATT -> GTGATATATTA
GTGATATATTA -> TGATATATTAA
TGATATATTAA -> GATATATTAAT
GATATATTAAT -> ATATATTAATG
ATATATTAATG -> TATATTAATGC
TATATTAATGC -> ATATTAATGCT
ATATTAATGCT -> TATTAATGCTG
TATTAATGCTG -> ATTAATGCTGA
ATTAATGCTGA -> TTAATGCTGAG
TTAATGCTGAG -> TAATGCTGAGG
TAATGCTGAGG -> AATGCTGAGGG
AATGCTGAGGG -> ATGCTGAGGGC
ATGCTGAGGGC -> TGCTGAGGGCT
TGCTGAGGGCT -> GCTGAGGGCTA
GCTGAGGGCTA -> CTGAGGGCTAA
CTGAGGGCTAA -> TGAGGGCTAAA
TGAGGGCTAAA -> GAGGGCTAAAT
GAGGGCTAAAT -> AGGGCTAAATT
AGGGCTAAATT -> GGGCTAAATTA
GGGCTAAATTA -> GGCTAAATTAT
GGCTAAATTAT -> GCTAAATTATG
GCTAAATTATG -> CTAAATTATGC
CTAAATTATGC -> TAAATTATGCT
TAAATTATGCT -> AAATTATGCTT
AAATTATGCTT -> AATTATGCTTT
AATTATGCTTT -> ATTATGCTTTT
ATTATGCTTTT -> TTATGCTTTTT
TTATGCTTTTT -> TATGCTTTTTA
TATGCTTTTTA -> ATGCTTTTTAT
ATGCTTTTTAT -> TGCTTTTTATT
TGCTTTTTATT -> GCTTTTTATTC
GCTTTTTATTC -> CTTTTTATTCA
CTTTTTATTCA -> TTTTTATTCAA
TTTTTATTCAA -> TTTTATTCAAT
TTTTATTCAAT -> TTTATTCAATA
TTTATTCAATA -> TTATTCAATAT
TTATTCAATAT -> TATTCAATATC
TATTCAATATC -> ATTCAATATCG
ATTCAATATCG -> TTCAATATCGG
TTCAATATCGG -> TCAATATCGGG
TCAATATCGGG -> CAATATCGGGG
CAATATCGGGG -> AATATCGGGGC
AATATCGGGGC -> ATATCGGGGCT
ATATCGGGGCT -> TATCGGGGCTC
TATCGGGGCTC -> ATCGGGGCTCA
ATCGGGGCTCA -> TCGGGGCTCAA
TCGGGGCTCAA -> CGGGGCTCAAG
CGGGGCTCAAG -> GGGGCTCAAGG
GGGGCTCAAGG -> GGGCTCAAGGC
GGGCTCAAGGC -> GGCTCAAGGCA
GGCTCAAGGCA -> GCTCAAGGCAA
GCTCAAGGCAA -> CTCAAGGCAAA
CTCAAGGCAAA -> TCAAGGCAAAA
TCAAGGCAAAA -> CAAGGCAAAAA
CAAGGCAAAAA -> AAGGCAAAAAC
AAGGCAAAAAC -> AGGCAAAAACA
AGGCAAAAACA -> GGCAAAAACAA
GGCAAAAACAA -> GCAAAAACAAG
GCAAAAACAAG -> CAAAAACAAGC
CAAAAACAAGC -> AAAAACAAGCG
AAAAACAAGCG -> AAAACAAGCGT
AAAACAAGCGT -> AAACAAGCGTG
AAACAAGCGTG -> AACAAGCGTGT
AACAAGCGTGT -> ACAAGCGTGTA
ACAAGCGTGTA -> CAAGCGTGTAC
CAAGCGTGTAC -> AAGCGTGTACC
AAGCGTGTACC -> AGCGTGTACCT
AGCGTGTACCT -> GCGTGTACCTA
GCGTGTACCTA -> CGTGTACCTAC
CGTGTACCTAC -> GTGTACCTACA
GTGTACCTACA -> TGTACCTACAC
TGTACCTACAC -> GTACCTACACA
GTACCTACACA -> TACCTACACAC
TACCTACACAC -> ACCTACACACG
ACCTACACACG -> CCTACACACGT
CCTACACACGT -> CTACACACGTC
CTACACACGTC -> TACACACGTCG
TACACACGTCG -> ACACACGTCGC
ACACACGTCGC -> CACACGTCGCA
CACACGTCGCA -> ACACGTCGCAC
ACACGTCGCAC -> CACGTCGCACC
CACGTCGCACC -> ACGTCGCACCT
ACGTCGCACCT -> CGTCGCACCTG
CGTCGCACCTG -> GTCGCACCTGC
GTCGCACCTGC -> TCGCACCTGCA
TCGCACCTGCA -> CGCACCTGCAT
CGCACCTGCAT -> GCACCTGCATG
GCACCTGCATG -> CACCTGCATGG
CACCTGCATGG -> ACCTGCATGGT
ACCTGCATGGT -> CCTGCATGGTT
CCTGCATGGTT -> CTGCATGGTTC
CTGCATGGTTC -> TGCATGGTTCT
TGCATGGTTCT -> GCATGGTTCTA
GCATGGTTCTA -> CATGGTTCTAC
CATGGTTCTAC -> ATGGTTCTACT
ATGGTTCTACT -> TGGTTCTACTC
TGGTTCTACTC -> GGTTCTACTCT
GGTTCTACTCT -> GTTCTACTCTT
GTTCTACTCTT -> TTCTACTCTTT
TTCTACTCTTT -> TCTACTCTTTC
TCTACTCTTTC -> CTACTCTTTCA
CTACTCTTTCA -> TACTCTTTCAG
TACTCTTTCAG -> ACTCTTTCAGG
ACTCTTTCAGG -> CTCTTTCAGGG
CTCTTTCAGGG -> TCTTTCAGGGT
TCTTTCAGGGT -> CTTTCAGGGTA
CTTTCAGGGTA -> TTTCAGGGTAA
TTTCAGGGTAA -> TTCAGGGTAAT
TTCAGGGTAAT -> TCAGGGTAATA
TCAGGGTAATA -> CAGGGTAATAG
CAGGGTAATAG -> AGGGTAATAGT
AGGGTAATAGT -> GGGTAATAGTA
GGGTAATAGTA -> GGTAATAGTAC
GGTAATAGTAC -> GTAATAGTACG
GTAATAGTACG -> TAATAGTACGT
TAATAGTACGT -> AATAGTACGTC
AATAGTACGTC -> ATAGTACGTCG
ATAGTACGTCG -> TAGTACGTCGT
TAGTACGTCGT -> AGTACGTCGTT
AGTACGTCGTT -> GTACGTCGTTG
GTACGTCGTTG -> TACGTCGTTGT
TACGTCGTTGT -> ACGTCGTTGTT
ACGTCGTTGTT -> CGTCGTTGTTT
CGTCGTTGTTT -> GTCGTTGTTTT
GTCGTTGTTTT -> TCGTTGTTTTA
TCGTTGTTTTA -> CGTTGTTTTAA
CGTTGTTTTAA -> GTTGTTTTAAG
GTTGTTTTAAG -> TTGTTTTAAGA
TTGTTTTAAGA -> TGTTTTAAGAC
TGTTTTAAGAC -> GTTTTAAGACC
GTTTTAAGACC -> TTTTAAGACCA
TTTTAAGACCA -> TTTAAGACCAG
TTTAAGACCAG -> TTAAGACCAGG
TTAAGACCAGG -> TAAGACCAGGT
TAAGACCAGGT -> AAGACCAGGTT
AAGACCAGGTT -> AGACCAGGTTT
AGACCAGGTTT -> GACCAGGTTTT
GACCAGGTTTT -> ACCAGGTTTTG
ACCAGGTTTTG -> CCAGGTTTTGA
CCAGGTTTTGA -> CAGGTTTTGAT
CAGGTTTTGAT -> AGGTTTTGATC
AGGTTTTGATC -> GGTTTTGATCA
GGTTTTGATCA -> GTTTTGATCAG
GTTTTGATCAG -> TTTTGATCAGA
TTTTGATCAGA -> TTTGATCAGAT
TTTGATCAGAT -> TTGATCAGATT
TTGATCAGATT -> TGATCAGATTG
TGATCAGATTG -> GATCAGATTGC
GATCAGATTGC -> ATCAGATTGCC
ATCAGATTGCC -> TCAGATTGCCG
TCAGATTGCCG -> CAGATTGCCGT
CAGATTGCCGT -> AGATTGCCGTA
AGATTGCCGTA -> GATTGCCGTAT
GATTGCCGTAT -> ATTGCCGTATA
ATTGCCGTATA -> TTGCCGTATAG
TTGCCGTATAG -> TGCCGTATAGG
TGCCGTATAGG -> GCCGTATAGGT
GCCGTATAGGT -> CCGTATAGGTC
CCGTATAGGTC -> CGTATAGGTCG
CGTATAGGTCG -> GTATAGGTCGG
GTATAGGTCGG -> TATAGGTCGGT
TATAGGTCGGT -> ATAGGTCGGTG
ATAGGTCGGTG -> TAGGTCGGTGA
TAGGTCGGTGA -> AGGTCGGTGAG
AGGTCGGTGAG -> GGTCGGTGAGC
GGTCGGTGAGC -> GTCGGTGAGCG
GTCGGTGAGCG -> TCGGTGAGCGA
TCGGTGAGCGA -> CGGTGAGCGAC
CGGTGAGCGAC -> GGTGAGCGACA
GGTGAGCGACA -> GTGAGCGACAG
GTGAGCGACAG -> TGAGCGACAGA
TGAGCGACAGA -> GAGCGACAGAA
GAGCGACAGAA -> AGCGACAGAAC
AGCGACAGAAC -> GCGACAGAACC
GCGACAGAACC -> CGACAGAACCA
CGACAGAACCA -> GACAGAACCAA
GACAGAACCAA -> ACAGAACCAAG
ACAGAACCAAG -> CAGAACCAAGA
CAGAACCAAGA -> AGAACCAAGAC
AGAACCAAGAC -> GAACCAAGACG
GAACCAAGACG -> AACCAAGACGC
AACCAAGACGC -> ACCAAGACGCT
ACCAAGACGCT -> CCAAGACGCTA
CCAAGACGCTA -> CAAGACGCTAG
CAAGACGCTAG -> AAGACGCTAGT
AAGACGCTAGT -> AGACGCTAGTA
AGACGCTAGTA -> GACGCTAGTAG
GACGCTAGTAG -> ACGCTAGTAGC
ACGCTAGTAGC -> CGCTAGTAGCA
CGCTAGTAGCA -> GCTAGTAGCAA
GCTAGTAGCAA -> CTAGTAGCAAA
CTAGTAGCAAA -> TAGTAGCAAAT
TAGTAGCAAAT -> AGTAGCAAATT
AGTAGCAAATT -> GTAGCAAATTT
GTAGCAAATTT -> TAGCAAATTTA
TAGCAAATTTA -> AGCAAATTTAG
AGCAAATTTAG -> GCAAATTTAGC
GCAAATTTAGC -> CAAATTTAGCA
CAAATTTAGCA -> AAATTTAGCAG
AAATTTAGCAG -> AATTTAGCAGA
AATTTAGCAGA -> ATTTAGCAGAT
ATTTAGCAGAT -> TTTAGCAGATT
TTTAGCAGATT -> TTAGCAGATTG
TTAGCAGATTG -> TAGCAGATTGT
TAGCAGATTGT -> AGCAGATTGTG
AGCAGATTGTG -> GCAGATTGTGC
GCAGATTGTGC -> CAGATTGTGCT
CAGATTGTGCT -> AGATTGTGCTG
AGATTGTGCTG -> GATTGTGCTGC
GATTGTGCTGC -> ATTGTGCTGCG
ATTGTGCTGCG -> TTGTGCTGCGT
TTGTGCTGCGT -> TGTGCTGCGTT
TGTGCTGCGTT -> GTGCTGCGTTT
GTGCTGCGTTT -> TGCTGCGTTTG
TGCTGCGTTTG -> GCTGCGTTTGA
GCTGCGTTTGA -> CTGCGTTTGAT
CTGCGTTTGAT -> TGCGTTTGATT
TGCGTTTGATT -> GCGTTTGATTT
GCGTTTGATTT -> CGTTTGATTTA
CGTTTGATTTA -> GTTTGATTTAT
GTTTGATTTAT -> TTTGATTTATT
TTTGATTTATT -> TTGATTTATTA
TTGATTTATTA -> TGATTTATTAT
TGATTTATTAT -> GATTTATTATC
GATTTATTATC -> ATTTATTATCA
ATTTATTATCA -> TTTATTATCAA
TTTATTATCAA -> TTATTATCAAC
TTATTATCAAC -> TATTATCAACC
TATTATCAACC -> ATTATCAACCT
ATTATCAACCT -> TTATCAACCTA
TTATCAACCTA -> TATCAACCTAC
TATCAACCTAC -> ATCAACCTACA
ATCAACCTACA -> TCAACCTACAC
TCAACCTACAC -> CAACCTACACC
CAACCTACACC -> AACCTACACCT
AACCTACACCT -> ACCTACACCTA
ACCTACACCTA -> CCTACACCTAA
CCTACACCTAA -> CTACACCTAAG
CTACACCTAAG -> TACACCTAAGC
TACACCTAAGC -> ACACCTAAGCA
ACACCTAAGCA -> CACCTAAGCAT
CACCTAAGCAT -> ACCTAAGCATC
ACCTAAGCATC -> CCTAAGCATCG
CCTAAGCATCG -> CTAAGCATCGA
CTAAGCATCGA -> TAAGCATCGAC
TAAGCATCGAC -> AAGCATCGACC
AAGCATCGACC -> AGCATCGACCG
AGCATCGACCG -> GCATCGACCGC
GCATCGACCGC -> CATCGACCGCA
CATCGACCGCA -> ATCGACCGCAA
ATCGACCGCAA -> TCGACCGCAAC
TCGACCGCAAC -> CGACCGCAACT
CGACCGCAACT -> GACCGCAACTC
GACCGCAACTC -> ACCGCAACTCC
ACCGCAACTCC -> CCGCAACTCCG
CCGCAACTCCG -> CGCAACTCCGA
CGCAACTCCGA -> GCAACTCCGAA
GCAACTCCGAA -> CAACTCCGAAG
CAACTCCGAAG -> AACTCCGAAGC
AACTCCGAAGC -> ACTCCGAAGCA
ACTCCGAAGCA -> CTCCGAAGCAG
CTCCGAAGCAG -> TCCGAAGCAGT
TCCGAAGCAGT -> CCGAAGCAGTT
CCGAAGCAGTT -> CGAAGCAGTTC
CGAAGCAGTTC -> GAAGCAGTTCC
GAAGCAGTTCC -> AAGCAGTTCCA
AAGCAGTTCCA -> AGCAGTTCCAT
AGCAGTTCCAT -> GCAGTTCCATA
GCAGTTCCATA -> CAGTTCCATAA
CAGTTCCATAA -> AGTTCCATAAG
AGTTCCATAAG -> GTTCCATAAGG
GTTCCATAAGG -> TTCCATAAGGA
TTCCATAAGGA -> TCCATAAGGAA
TCCATAAGGAA -> CCATAAGGAAT
CCATAAGGAAT -> CATAAGGAATC
CATAAGGAATC -> ATAAGGAATCG
ATAAGGAATCG -> TAAGGAATCGT
TAAGGAATCGT -> AAGGAATCGTT
AAGGAATCGTT -> AGGAATCGTTT
AGGAATCGTTT -> GGAATCGTTTG
GGAATCGTTTG -> GAATCGTTTGA
GAATCGTTTGA -> AATCGTTTGAT
AATCGTTTGAT -> ATCGTTTGATA
ATCGTTTGATA -> TCGTTTGATAG
TCGTTTGATAG -> CGTTTGATAGT
CGTTTGATAGT -> GTTTGATAGTT
GTTTGATAGTT -> TTTGATAGTTC
TTTGATAGTTC -> TTGATAGTTCT
TTGATAGTTCT -> TGATAGTTCTA
TGATAGTTCTA -> GATAGTTCTAT
GATAGTTCTAT -> ATAGTTCTATC
ATAGTTCTATC -> TAGTTCTATCG
TAGTTCTATCG -> AGTTCTATCGC
AGTTCTATCGC -> GTTCTATCGCG
GTTCTATCGCG -> TTCTATCGCGA
TTCTATCGCGA -> TCTATCGCGAG
TCTATCGCGAG -> CTATCGCGAGT
CTATCGCGAGT -> TATCGCGAGTT
TATCGCGAGTT -> ATCGCGAGTTA
ATCGCGAGTTA -> TCGCGAGTTAA
TCGCGAGTTAA -> CGCGAGTTAAC
CGCGAGTTAAC -> GCGAGTTAACT
GCGAGTTAACT -> CGAGTTAACTA
CGAGTTAACTA -> GAGTTAACTAT
GAGTTAACTAT -> AGTTAACTATA
AGTTAACTATA -> GTTAACTATAT
GTTAACTATAT -> TTAACTATATT
TTAACTATATT -> TAACTATATTT
TAACTATATTT -> AACTATATTTA
AACTATATTTA -> ACTATATTTAT
ACTATATTTAT -> CTATATTTATG
CTATATTTATG -> TATATTTATGA
TATATTTATGA -> ATATTTATGAC
ATATTTATGAC -> TATTTATGACT
TATTTATGACT -> ATTTATGACTG
ATTTATGACTG -> TTTATGACTGG
TTTATGACTGG -> TTATGACTGGT
TTATGACTGGT -> TATGACTGGTA
TATGACTGGTA -> ATGACTGGTAT
ATGACTGGTAT -> TGACTGGTATG
TGACTGGTATG -> GACTGGTATGG
GACTGGTATGG -> ACTGGTATGGC
ACTGGTATGGC -> CTGGTATGGCC
CTGGTATGGCC -> TGGTATGGCCG
TGGTATGGCCG -> GGTATGGCCGC
GGTATGGCCGC -> GTATGGCCGCC
GTATGGCCGCC -> TATGGCCGCCT
TATGGCCGCCT -> ATGGCCGCCTG
ATGGCCGCCTG -> TGGCCGCCTGC
TGGCCGCCTGC -> GGCCGCCTGCG
GGCCGCCTGCG -> GCCGCCTGCGA
GCCGCCTGCGA -> CCGCCTGCGAG
CCGCCTGCGAG -> CGCCTGCGAGA
CGCCTGCGAGA -> GCCTGCGAGAA
GCCTGCGAGAA -> CCTGCGAGAAA
CCTGCGAGAAA -> CTGCGAGAAAT
CTGCGAGAAAT -> TGCGAGAAATA
TGCGAGAAATA -> GCGAGAAATAT
GCGAGAAATAT -> CGAGAAATATG
CGAGAAATATG -> GAGAAATATGC
GAGAAATATGC -> AGAAATATGCA
AGAAATATGCA -> GAAATATGCAC
GAAATATGCAC -> AAATATGCACG
AAATATGCACG -> AATATGCACGA
ATATGCACGAC -> TATGCACGACT
TATGCACGACT -> ATGCACGACTG
ATGCACGACTG -> TGCACGACTGC
TGCACGACTGC -> GCACGACTGCC
GCACGACTGCC -> CACGACTGCCA
CACGACTGCCA -> ACGACTGCCAC
ACGACTGCCAC -> CGACTGCCACG
CGACTGCCACG -> GACTGCCACGC
GACTGCCACGC -> ACTGCCACGCG
ACTGCCACGCG -> CTGCCACGCGG
CTGCCACGCGG -> TGCCACGCGGG
TGCCACGCGGG -> GCCACGCGGGT
GCCACGCGGGT -> CCACGCGGGTG
CCACGCGGGTG -> CACGCGGGTGC
CACGCGGGTGC -> ACGCGGGTGCG
ACGCGGGTGCG -> CGCGGGTGCGT
CGCGGGTGCGT -> GCGGGTGCGTA
GCGGGTGCGTA -> CGGGTGCGTAT
CGGGTGCGTAT -> GGGTGCGTATG
GGGTGCGTATG -> GGTGCGTATGC
GGTGCGTATGC -> GTGCGTATGCG
GTGCGTATGCG -> TGCGTATGCGT
TGCGTATGCGT -> GCGTATGCGTG
GCGTATGCGTG -> CGTATGCGTGC
CGTATGCGTGC -> GTATGCGTGCA
GTATGCGTGCA -> TATGCGTGCAT
TATGCGTGCAT -> ATGCGTGCATC
ATGCGTGCATC -> TGCGTGCATCG
TGCGTGCATCG -> GCGTGCATCGG
GCGTGCATCGG -> CGTGCATCGGA
CGTGCATCGGA -> GTGCATCGGAG
GTGCATCGGAG -> TGCATCGGAGC
TGCATCGGAGC -> GCATCGGAGCT
GCATCGGAGCT -> CATCGGAGCTT
CATCGGAGCTT -> ATCGGAGCTTT
ATCGGAGCTTT -> TCGGAGCTTTC
TCGGAGCTTTC -> CGGAGCTTTCA
CGGAGCTTTCA -> GGAGCTTTCAA
GGAGCTTTCAA -> GAGCTTTCAAG
GAGCTTTCAAG -> AGCTTTCAAGG
AGCTTTCAAGG -> GCTTTCAAGGC
GCTTTCAAGGC -> CTTTCAAGGCT
CTTTCAAGGCT -> TTTCAAGGCTC
TTTCAAGGCTC -> TTCAAGGCTCG
TTCAAGGCTCG -> TCAAGGCTCGA
TCAAGGCTCGA -> CAAGGCTCGAA
CAAGGCTCGAA -> AAGGCTCGAAG
AAGGCTCGAAG -> AGGCTCGAAGT
AGGCTCGAAGT -> GGCTCGAAGTT
GGCTCGAAGTT -> GCTCGAAGTTT
GCTCGAAGTTT -> CTCGAAGTTTA
CTCGAAGTTTA -> TCGAAGTTTAG
TCGAAGTTTAG -> CGAAGTTTAGC
CGAAGTTTAGC -> GAAGTTTAGCT
GAAGTTTAGCT -> AAGTTTAGCTG
AAGTTTAGCTG -> AGTTTAGCTGC
AGTTTAGCTGC -> GTTTAGCTGCC
GTTTAGCTGCC -> TTTAGCTGCCG
TTTAGCTGCCG -> TTAGCTGCCGA
TTAGCTGCCGA -> TAGCTGCCGAA
TAGCTGCCGAA -> AGCTGCCGAAG
AGCTGCCGAAG -> GCTGCCGAAGG
GCTGCCGAAGG -> CTGCCGAAGGC
CTGCCGAAGGC -> TGCCGAAGGCA
TGCCGAAGGCA -> GCCGAAGGCAA
GCCGAAGGCAA -> CCGAAGGCAAT
CCGAAGGCAAT -> CGAAGGCAATT
CGAAGGCAATT -> GAAGGCAATTG
GAAGGCAATTG -> AAGGCAATTGG
AAGGCAATTGG -> AGGCAATTGGG
AGGCAATTGGG -> GGCAATTGGGT
GGCAATTGGGT -> GCAATTGGGTC
GCAATTGGGTC -> CAATTGGGTCG
CAATTGGGTCG -> AATTGGGTCGT
AATTGGGTCGT -> ATTGGGTCGTA
ATTGGGTCGTA -> TTGGGTCGTAC
TTGGGTCGTAC -> TGGGTCGTACT
TGGGTCGTACT -> GGGTCGTACTG
GGGTCGTACTG -> GGTCGTACTGC
GGTCGTACTGC -> GTCGTACTGCG
GTCGTACTGCG -> TCGTACTGCGG
TCGTACTGCGG -> CGTACTGCGGA
CGTACTGCGGA -> GTACTGCGGAC
GTACTGCGGAC -> TACTGCGGACC
TACTGCGGACC -> ACTGCGGACCA
ACTGCGGACCA -> CTGCGGACCAA
CTGCGGACCAA -> TGCGGACCAAG
TGCGGACCAAG -> GCGGACCAAGA
GCGGACCAAGA -> CGGACCAAGAC
CGGACCAAGAC -> GGACCAAGACC
GGACCAAGACC -> GACCAAGACCT
GACCAAGACCT -> ACCAAGACCTG
ACCAAGACCTG -> CCAAGACCTGA
CCAAGACCTGA -> CAAGACCTGAA
CAAGACCTGAA -> AAGACCTGAAA
AAGACCTGAAA -> AGACCTGAAAG
AGACCTGAAAG -> GACCTGAAAGC
GACCTGAAAGC -> ACCTGAAAGCC
ACCTGAAAGCC -> CCTGAAAGCCC
CCTGAAAGCCC -> CTGAAAGCCCT
CTGAAAGCCCT -> TGAAAGCCCTG
TGAAAGCCCTG -> GAAAGCCCTGC
GAAAGCCCTGC -> AAAGCCCTGCC
AAAGCCCTGCC -> AAGCCCTGCCT
AAGCCCTGCCT -> AGCCCTGCCTG
AGCCCTGCCTG -> GCCCTGCCTGA
GCCCTGCCTGA -> CCCTGCCTGAG
CCCTGCCTGAG -> CCTGCCTGAGG
CCTGCCTGAGG -> CTGCCTGAGGT
CTGCCTGAGGT -> TGCCTGAGGTG
TGCCTGAGGTG -> GCCTGAGGTGC
GCCTGAGGTGC -> CCTGAGGTGCG
CCTGAGGTGCG -> CTGAGGTGCGT
CTGAGGTGCGT -> TGAGGTGCGTA
TGAGGTGCGTA -> GAGGTGCGTAG
GAGGTGCGTAG -> AGGTGCGTAGT
AGGTGCGTAGT -> GGTGCGTAGTA
GGTGCGTAGTA -> GTGCGTAGTAG
GTGCGTAGTAG -> TGCGTAGTAGG
TGCGTAGTAGG -> GCGTAGTAGGA
GCGTAGTAGGA -> CGTAGTAGGAA
CGTAGTAGGAA -> GTAGTAGGAAG
GTAGTAGGAAG -> TAGTAGGAAGG
TAGTAGGAAGG -> AGTAGGAAGGA
AGTAGGAAGGA -> GTAGGAAGGAA
GTAGGAAGGAA -> TAGGAAGGAAC
TAGGAAGGAAC -> AGGAAGGAACC
AGGAAGGAACC -> GGAAGGAACCT
GGAAGGAACCT -> GAAGGAACCTG
GAAGGAACCTG -> AAGGAACCTGA
AAGGAACCTGA -> AGGAACCTGAT
AGGAACCTGAT -> GGAACCTGATG
GGAACCTGATG -> GAACCTGATGA
GAACCTGATGA -> AACCTGATGAA
AACCTGATGAA -> ACCTGATGAAC
ACCTGATGAAC -> CCTGATGAACA
CCTGATGAACA -> CTGATGAACAG
CTGATGAACAG -> TGATGAACAGC
TGATGAACAGC -> GATGAACAGCC
GATGAACAGCC -> ATGAACAGCCC
ATGAACAGCCC -> TGAACAGCCCT
TGAACAGCCCT -> GAACAGCCCTT
GAACAGCCCTT -> AACAGCCCTTG
AACAGCCCTTG -> ACAGCCCTTGG
ACAGCCCTTGG -> CAGCCCTTGGC
